WPUJQGLJEF -> ninesixsix
WPUJQGLIQO -> ninesixtwo
WPUJQGLNZY -> ninesixone
WPUJPSUJEF -> ninetwosix
WPUJPSUIQO -> ninetwotwo
WPUJPSUNZY -> ninetwoone
WPUJUBEJEF -> nineonesix
WPUJUBEIQO -> nineonetwo
WPUJUBENZY -> nineoneone
RPKAABEJEF -> sixninesix
RPKAABEIQO -> sixninetwo
RPKAABENZY -> sixnineone
RPKVARVTZY -> sixsixnine
RPKVARDTRY -> sixsixfive
RPKVARDNSL -> sixsixfour
RPKVARJXVO -> sixsixzero
RPKIATEJEF -> sixfivesix
RPKIATEIQO -> sixfivetwo
RPKIATENZY -> sixfiveone
RPKIUURJEF -> sixfoursix
RPKIUURIQO -> sixfourtwo
RPKIUURNZY -> sixfourone
RPKUMAVTZY -> sixtwonine
RPKUMADTRY -> sixtwofive
RPKUMADNSL -> sixtwofour
RPKUMAJXVO -> sixtwozero
RPKZVKVTZY -> sixonenine
RPKZVKDTRY -> sixonefive
RPKZVKDNSL -> sixonefour
RPKZVKJXVO -> sixonezero
RPKOEXUJEF -> sixzerosix
RPKOEXUIQO -> sixzerotwo
RPKOEXUNZY -> sixzeroone
EPMJQGLJEF -> fivesixsix
EPMJQGLIQO -> fivesixtwo
EPMJQGLNZY -> fivesixone
EPMJPSUJEF -> fivetwosix
EPMJPSUIQO -> fivetwotwo
EPMJPSUNZY -> fivetwoone
EPMJUBEJEF -> fiveonesix
EPMJUBEIQO -> fiveonetwo
EPMJUBENZY -> fiveoneone
EJNWQGLJEF -> foursixsix
EJNWQGLIQO -> foursixtwo
EJNWQGLNZY -> foursixone
EJNWPSUJEF -> fourtwosix
EJNWPSUIQO -> fourtwotwo
EJNWPSUNZY -> fourtwoone
EJNWUBEJEF -> fouronesix
EJNWUBEIQO -> fouronetwo
EJNWUBENZY -> fouroneone
QBTAABEJEF -> twoninesix
QBTAABEIQO -> twoninetwo
QBTAABENZY -> twonineone
QBTVARVTZY -> twosixnine
QBTVARDTRY -> twosixfive
QBTVARDNSL -> twosixfour
QBTVARJXVO -> twosixzero
QBTIATEJEF -> twofivesix
QBTIATEIQO -> twofivetwo
QBTIATENZY -> twofiveone
QBTIUURJEF -> twofoursix
QBTIUURIQO -> twofourtwo
QBTIUURNZY -> twofourone
QBTUMAVTZY -> twotwonine
QBTUMADTRY -> twotwofive
QBTUMADNSL -> twotwofour
QBTUMAJXVO -> twotwozero
QBTZVKVTZY -> twoonenine
QBTZVKDTRY -> twoonefive
QBTZVKDNSL -> twoonefour
QBTZVKJXVO -> twoonezero
QBTOEXUJEF -> twozerosix
QBTOEXUIQO -> twozerotwo
QBTOEXUNZY -> twozeroone
VKDAABEJEF -> oneninesix
VKDAABEIQO -> oneninetwo
VKDAABENZY -> onenineone
VKDVARVTZY -> onesixnine
VKDVARDTRY -> onesixfive
VKDVARDNSL -> onesixfour
VKDVARJXVO -> onesixzero
VKDIATEJEF -> onefivesix
VKDIATEIQO -> onefivetwo
VKDIATENZY -> onefiveone
VKDIUURJEF -> onefoursix
VKDIUURIQO -> onefourtwo
VKDIUURNZY -> onefourone
VKDUMAVTZY -> onetwonine
VKDUMADTRY -> onetwofive
VKDUMADNSL -> onetwofour
VKDUMAJXVO -> onetwozero
VKDZVKVTZY -> oneonenine
VKDZVKDTRY -> oneonefive
VKDZVKDNSL -> oneonefour
VKDZVKJXVO -> oneonezero
VKDOEXUJEF -> onezerosix
VKDOEXUIQO -> onezerotwo
VKDOEXUNZY -> onezeroone
KTQZQGLJEF -> zerosixsix
KTQZQGLIQO -> zerosixtwo
KTQZQGLNZY -> zerosixone
KTQZPSUJEF -> zerotwosix
KTQZPSUIQO -> zerotwotwo
KTQZPSUNZY -> zerotwoone
KTQZUBEJEF -> zeroonesix
KTQZUBEIQO -> zeroonetwo
KTQZUBENZY -> zerooneone

YVUMOTHMNLBC -> nineninenine
YVUMOTHMVLTC -> nineninefive
YVUMOTHMVFUP -> nineninefour
YVUMOTHMBPXS -> nineninezero
YVUMXTOJHBGJ -> nineeightsix
YVUMXTOJHASS -> nineeighttwo
YVUMXTOJHFBC -> nineeightone
YVUMJXZMNBGJ -> ninesevensix
YVUMJXZMNASS -> nineseventwo
YVUMJXZMNFBC -> ninesevenone
YVUMJTXMSNHN -> ninesixeight
YVUMJTXYWYKT -> ninesixseven
YVUMJTXXTCKC -> ninesixthree
YVUMWTZMNLBC -> ninefivenine
YVUMWTZMVLTC -> ninefivefive
YVUMWTZMVFUP -> ninefivefour
YVUMWTZMBPXS -> ninefivezero
YVUMWNAZNLBC -> ninefournine
YVUMWNAZVLTC -> ninefourfive
YVUMWNAZVFUP -> ninefourfour
YVUMWNAZBPXS -> ninefourzero
YVUMIUDMWBGJ -> ninethreesix
YVUMIUDMWASS -> ninethreetwo
YVUMIUDMWFBC -> ninethreeone
YVUMIFGMSNHN -> ninetwoeight
YVUMIFGYWYKT -> ninetwoseven
YVUMIFGXTCKC -> ninetwothree
YVUMNOQMSNHN -> nineoneeight
YVUMNOQYWYKT -> nineoneseven
YVUMNOQXTCKC -> nineonethree
YVUMCXDCNLBC -> ninezeronine
YVUMCXDCVLTC -> ninezerofive
YVUMCXDCVFUP -> ninezerofour
YVUMCXDCBPXS -> ninezerozero
HVBJIOMDWBGJ -> eightninesix
HVBJIOMDWASS -> eightninetwo
HVBJIOMDWFBC -> eightnineone
HVBJIJMTNLBC -> eightsixnine
HVBJIJMTVLTC -> eightsixfive
HVBJIJMTVFUP -> eightsixfour
HVBJIJMTBPXS -> eightsixzero
HVBJIWMVWBGJ -> eightfivesix
HVBJIWMVWASS -> eightfivetwo
HVBJIWMVWFBC -> eightfiveone
HVBJIWGWJBGJ -> eightfoursix
HVBJIWGWJASS -> eightfourtwo
HVBJIWGWJFBC -> eightfourone
HVBJIIYCNLBC -> eighttwonine
HVBJIIYCVLTC -> eighttwofive
HVBJIIYCVFUP -> eighttwofour
HVBJIIYCBPXS -> eighttwozero
HVBJINHMNLBC -> eightonenine
HVBJINHMVLTC -> eightonefive
HVBJINHMVFUP -> eightonefour
HVBJINHMBPXS -> eightonezero
HVBJICQZMBGJ -> eightzerosix
HVBJICQZMASS -> eightzerotwo
HVBJICQZMFBC -> eightzeroone
TZMMOOMDWBGJ -> sevenninesix
TZMMOOMDWASS -> sevenninetwo
TZMMOOMDWFBC -> sevennineone
TZMMOJMTNLBC -> sevensixnine
TZMMOJMTVLTC -> sevensixfive
TZMMOJMTVFUP -> sevensixfour
TZMMOJMTBPXS -> sevensixzero
TZMMOWMVWBGJ -> sevenfivesix
TZMMOWMVWASS -> sevenfivetwo
TZMMOWMVWFBC -> sevenfiveone
TZMMOWGWJBGJ -> sevenfoursix
TZMMOWGWJASS -> sevenfourtwo
TZMMOWGWJFBC -> sevenfourone
TZMMOIYCNLBC -> seventwonine
TZMMOIYCVLTC -> seventwofive
TZMMOIYCVFUP -> seventwofour
TZMMOIYCBPXS -> seventwozero
TZMMONHMNLBC -> sevenonenine
TZMMONHMVLTC -> sevenonefive
TZMMONHMVFUP -> sevenonefour
TZMMONHMBPXS -> sevenonezero
TZMMOCQZMBGJ -> sevenzerosix
TZMMOCQZMASS -> sevenzerotwo
TZMMOCQZMFBC -> sevenzeroone
TVKDTOQMSNHN -> sixnineeight
TVKDTOQYWYKT -> sixnineseven
TVKDTOQXTCKC -> sixninethree
TVKMTVNXNLBC -> sixeightnine
TVKMTVNXVLTC -> sixeightfive
TVKMTVNXVFUP -> sixeightfour
TVKMTVNXBPXS -> sixeightzero
TVKYXGQDNLBC -> sixsevennine
TVKYXGQDVLTC -> sixsevenfive
TVKYXGQDVFUP -> sixsevenfour
TVKYXGQDBPXS -> sixsevenzero
TVKLTGQMSNHN -> sixfiveeight
TVKLTGQYWYKT -> sixfiveseven
TVKLTGQXTCKC -> sixfivethree
TVKLNHDMSNHN -> sixfoureight
TVKLNHDYWYKT -> sixfourseven
TVKLNHDXTCKC -> sixfourthree
TVKXUKQMNLBC -> sixthreenine
TVKXUKQMVLTC -> sixthreefive
TVKXUKQMVFUP -> sixthreefour
TVKXUKQMBPXS -> sixthreezero
TVKRXKGMSNHN -> sixzeroeight
TVKRXKGYWYKT -> sixzeroseven
TVKRXKGXTCKC -> sixzerothree
GVMMOTHMNLBC -> fiveninenine
GVMMOTHMVLTC -> fiveninefive
GVMMOTHMVFUP -> fiveninefour
GVMMOTHMBPXS -> fiveninezero
GVMMXTOJHBGJ -> fiveeightsix
GVMMXTOJHASS -> fiveeighttwo
GVMMXTOJHFBC -> fiveeightone
GVMMJXZMNBGJ -> fivesevensix
GVMMJXZMNASS -> fiveseventwo
GVMMJXZMNFBC -> fivesevenone
GVMMJTXMSNHN -> fivesixeight
GVMMJTXYWYKT -> fivesixseven
GVMMJTXXTCKC -> fivesixthree
GVMMWTZMNLBC -> fivefivenine
GVMMWTZMVLTC -> fivefivefive
GVMMWTZMVFUP -> fivefivefour
GVMMWTZMBPXS -> fivefivezero
GVMMWNAZNLBC -> fivefournine
GVMMWNAZVLTC -> fivefourfive
GVMMWNAZVFUP -> fivefourfour
GVMMWNAZBPXS -> fivefourzero
GVMMIUDMWBGJ -> fivethreesix
GVMMIUDMWASS -> fivethreetwo
GVMMIUDMWFBC -> fivethreeone
GVMMIFGMSNHN -> fivetwoeight
GVMMIFGYWYKT -> fivetwoseven
GVMMIFGXTCKC -> fivetwothree
GVMMNOQMSNHN -> fiveoneeight
GVMMNOQYWYKT -> fiveoneseven
GVMMNOQXTCKC -> fiveonethree
GVMMCXDCNLBC -> fivezeronine
GVMMCXDCVLTC -> fivezerofive
GVMMCXDCVFUP -> fivezerofour
GVMMCXDCBPXS -> fivezerozero
GPNZOTHMNLBC -> fourninenine
GPNZOTHMVLTC -> fourninefive
GPNZOTHMVFUP -> fourninefour
GPNZOTHMBPXS -> fourninezero
GPNZXTOJHBGJ -> foureightsix
GPNZXTOJHASS -> foureighttwo
GPNZXTOJHFBC -> foureightone
GPNZJXZMNBGJ -> foursevensix
GPNZJXZMNASS -> fourseventwo
GPNZJXZMNFBC -> foursevenone
GPNZJTXMSNHN -> foursixeight
GPNZJTXYWYKT -> foursixseven
GPNZJTXXTCKC -> foursixthree
GPNZWTZMNLBC -> fourfivenine
GPNZWTZMVLTC -> fourfivefive
GPNZWTZMVFUP -> fourfivefour
GPNZWTZMBPXS -> fourfivezero
GPNZWNAZNLBC -> fourfournine
GPNZWNAZVLTC -> fourfourfive
GPNZWNAZVFUP -> fourfourfour
GPNZWNAZBPXS -> fourfourzero
GPNZIUDMWBGJ -> fourthreesix
GPNZIUDMWASS -> fourthreetwo
GPNZIUDMWFBC -> fourthreeone
GPNZIFGMSNHN -> fourtwoeight
GPNZIFGYWYKT -> fourtwoseven
GPNZIFGXTCKC -> fourtwothree
GPNZNOQMSNHN -> fouroneeight
GPNZNOQYWYKT -> fouroneseven
GPNZNOQXTCKC -> fouronethree
GPNZCXDCNLBC -> fourzeronine
GPNZCXDCVLTC -> fourzerofive
GPNZCXDCVFUP -> fourzerofour
GPNZCXDCBPXS -> fourzerozero
SWQMXOMDWBGJ -> threeninesix
SWQMXOMDWASS -> threeninetwo
SWQMXOMDWFBC -> threenineone
SWQMXJMTNLBC -> threesixnine
SWQMXJMTVLTC -> threesixfive
SWQMXJMTVFUP -> threesixfour
SWQMXJMTBPXS -> threesixzero
SWQMXWMVWBGJ -> threefivesix
SWQMXWMVWASS -> threefivetwo
SWQMXWMVWFBC -> threefiveone
SWQMXWGWJBGJ -> threefoursix
SWQMXWGWJASS -> threefourtwo
SWQMXWGWJFBC -> threefourone
SWQMXIYCNLBC -> threetwonine
SWQMXIYCVLTC -> threetwofive
SWQMXIYCVFUP -> threetwofour
SWQMXIYCBPXS -> threetwozero
SWQMXNHMNLBC -> threeonenine
SWQMXNHMVLTC -> threeonefive
SWQMXNHMVFUP -> threeonefour
SWQMXNHMBPXS -> threeonezero
SWQMXCQZMBGJ -> threezerosix
SWQMXCQZMASS -> threezerotwo
SWQMXCQZMFBC -> threezeroone
SHTDTOQMSNHN -> twonineeight
SHTDTOQYWYKT -> twonineseven
SHTDTOQXTCKC -> twoninethree
SHTMTVNXNLBC -> twoeightnine
SHTMTVNXVLTC -> twoeightfive
SHTMTVNXVFUP -> twoeightfour
SHTMTVNXBPXS -> twoeightzero
SHTYXGQDNLBC -> twosevennine
SHTYXGQDVLTC -> twosevenfive
SHTYXGQDVFUP -> twosevenfour
SHTYXGQDBPXS -> twosevenzero
SHTLTGQMSNHN -> twofiveeight
SHTLTGQYWYKT -> twofiveseven
SHTLTGQXTCKC -> twofivethree
SHTLNHDMSNHN -> twofoureight
SHTLNHDYWYKT -> twofourseven
SHTLNHDXTCKC -> twofourthree
SHTXUKQMNLBC -> twothreenine
SHTXUKQMVLTC -> twothreefive
SHTXUKQMVFUP -> twothreefour
SHTXUKQMBPXS -> twothreezero
SHTRXKGMSNHN -> twozeroeight
SHTRXKGYWYKT -> twozeroseven
SHTRXKGXTCKC -> twozerothree
XQDDTOQMSNHN -> onenineeight
XQDDTOQYWYKT -> onenineseven
XQDDTOQXTCKC -> oneninethree
XQDMTVNXNLBC -> oneeightnine
XQDMTVNXVLTC -> oneeightfive
XQDMTVNXVFUP -> oneeightfour
XQDMTVNXBPXS -> oneeightzero
XQDYXGQDNLBC -> onesevennine
XQDYXGQDVLTC -> onesevenfive
XQDYXGQDVFUP -> onesevenfour
XQDYXGQDBPXS -> onesevenzero
XQDLTGQMSNHN -> onefiveeight
XQDLTGQYWYKT -> onefiveseven
XQDLTGQXTCKC -> onefivethree
XQDLNHDMSNHN -> onefoureight
XQDLNHDYWYKT -> onefourseven
XQDLNHDXTCKC -> onefourthree
XQDXUKQMNLBC -> onethreenine
XQDXUKQMVLTC -> onethreefive
XQDXUKQMVFUP -> onethreefour
XQDXUKQMBPXS -> onethreezero
XQDRXKGMSNHN -> onezeroeight
XQDRXKGYWYKT -> onezeroseven
XQDRXKGXTCKC -> onezerothree
MZQCOTHMNLBC -> zeroninenine
MZQCOTHMVLTC -> zeroninefive
MZQCOTHMVFUP -> zeroninefour
MZQCOTHMBPXS -> zeroninezero
MZQCXTOJHBGJ -> zeroeightsix
MZQCXTOJHASS -> zeroeighttwo
MZQCXTOJHFBC -> zeroeightone
MZQCJXZMNBGJ -> zerosevensix
MZQCJXZMNASS -> zeroseventwo
MZQCJXZMNFBC -> zerosevenone
MZQCJTXMSNHN -> zerosixeight
MZQCJTXYWYKT -> zerosixseven
MZQCJTXXTCKC -> zerosixthree
MZQCWTZMNLBC -> zerofivenine
MZQCWTZMVLTC -> zerofivefive
MZQCWTZMVFUP -> zerofivefour
MZQCWTZMBPXS -> zerofivezero
MZQCWNAZNLBC -> zerofournine
MZQCWNAZVLTC -> zerofourfive
MZQCWNAZVFUP -> zerofourfour
MZQCWNAZBPXS -> zerofourzero
MZQCIUDMWBGJ -> zerothreesix
MZQCIUDMWASS -> zerothreetwo
MZQCIUDMWFBC -> zerothreeone
MZQCIFGMSNHN -> zerotwoeight
MZQCIFGYWYKT -> zerotwoseven
MZQCIFGXTCKC -> zerotwothree
MZQCNOQMSNHN -> zerooneeight
MZQCNOQYWYKT -> zerooneseven
MZQCNOQXTCKC -> zeroonethree
MZQCCXDCNLBC -> zerozeronine
MZQCCXDCVLTC -> zerozerofive
MZQCCXDCVFUP -> zerozerofour
MZQCCXDCBPXS -> zerozerozero

WMUMPCIIX -> sixsixsix
WMUMPCHUG -> sixsixtwo
WMUMPCMDQ -> sixsixone
WMULBLIIX -> sixtwosix
WMULBLHUG -> sixtwotwo
WMULBLMDQ -> sixtwoone
WMUQKVIIX -> sixonesix
WMUQKVHUG -> sixonetwo
WMUQKVMDQ -> sixoneone
VYDMPCIIX -> twosixsix
VYDMPCHUG -> twosixtwo
VYDMPCMDQ -> twosixone
VYDLBLIIX -> twotwosix
VYDLBLHUG -> twotwotwo
VYDLBLMDQ -> twotwoone
VYDQKVIIX -> twoonesix
VYDQKVHUG -> twoonetwo
VYDQKVMDQ -> twooneone
AHNMPCIIX -> onesixsix
AHNMPCHUG -> onesixtwo
AHNMPCMDQ -> onesixone
AHNLBLIIX -> onetwosix
AHNLBLHUG -> onetwotwo
AHNLBLMDQ -> onetwoone
AHNQKVIIX -> oneonesix
AHNQKVHUG -> oneonetwo
AHNQKVMDQ -> oneoneone

EMQAGZQLDLUNR -> ninenineeight
EMQAGZQLPPFQX -> ninenineseven
EMQAGZQLOMJQG -> nineninethree
EMQAPZXIOGSHG -> nineeightnine
EMQAPZXIOOSZG -> nineeightfive
EMQAPZXIOOMAT -> nineeightfour
EMQAPZXIOUWDW -> nineeightzero
EMQABDILUGSHG -> ninesevennine
EMQABDILUOSZG -> ninesevenfive
EMQABDILUOMAT -> ninesevenfour
EMQABDILUUWDW -> ninesevenzero
EMQAOZILDLUNR -> ninefiveeight
EMQAOZILPPFQX -> ninefiveseven
EMQAOZILOMJQG -> ninefivethree
EMQAOTJYDLUNR -> ninefoureight
EMQAOTJYPPFQX -> ninefourseven
EMQAOTJYOMJQG -> ninefourthree
EMQAAAMLDGSHG -> ninethreenine
EMQAAAMLDOSZG -> ninethreefive
EMQAAAMLDOMAT -> ninethreefour
EMQAAAMLDUWDW -> ninethreezero
EMQAUDMBDLUNR -> ninezeroeight
EMQAUDMBPPFQX -> ninezeroseven
EMQAUDMBOMJQG -> ninezerothree
NMXXAUVCDGSHG -> eightninenine
NMXXAUVCDOSZG -> eightninefive
NMXXAUVCDOMAT -> eightninefour
NMXXAUVCDUWDW -> eightninezero
NMXXADVJAAIMN -> eighteightsix
NMXXADVJAAHYW -> eighteighttwo
NMXXADVJAAMHG -> eighteightone
NMXXAPZUDGIMN -> eightsevensix
NMXXAPZUDGHYW -> eightseventwo
NMXXAPZUDGMHG -> eightsevenone
NMXXAPVSDLUNR -> eightsixeight
NMXXAPVSPPFQX -> eightsixseven
NMXXAPVSOMJQG -> eightsixthree
NMXXACVUDGSHG -> eightfivenine
NMXXACVUDOSZG -> eightfivefive
NMXXACVUDOMAT -> eightfivefour
NMXXACVUDUWDW -> eightfivezero
NMXXACPVQGSHG -> eightfournine
NMXXACPVQOSZG -> eightfourfive
NMXXACPVQOMAT -> eightfourfour
NMXXACPVQUWDW -> eightfourzero
NMXXAOWYDPIMN -> eightthreesix
NMXXAOWYDPHYW -> eightthreetwo
NMXXAOWYDPMHG -> eightthreeone
NMXXAOHBDLUNR -> eighttwoeight
NMXXAOHBPPFQX -> eighttwoseven
NMXXAOHBOMJQG -> eighttwothree
NMXXATQLDLUNR -> eightoneeight
NMXXATQLPPFQX -> eightoneseven
NMXXATQLOMJQG -> eightonethree
NMXXAIZYTGSHG -> eightzeronine
NMXXAIZYTOSZG -> eightzerofive
NMXXAIZYTOMAT -> eightzerofour
NMXXAIZYTUWDW -> eightzerozero
ZQIAGUVCDGSHG -> sevenninenine
ZQIAGUVCDOSZG -> sevenninefive
ZQIAGUVCDOMAT -> sevenninefour
ZQIAGUVCDUWDW -> sevenninezero
ZQIAGDVJAAIMN -> seveneightsix
ZQIAGDVJAAHYW -> seveneighttwo
ZQIAGDVJAAMHG -> seveneightone
ZQIAGPZUDGIMN -> sevensevensix
ZQIAGPZUDGHYW -> sevenseventwo
ZQIAGPZUDGMHG -> sevensevenone
ZQIAGPVSDLUNR -> sevensixeight
ZQIAGPVSPPFQX -> sevensixseven
ZQIAGPVSOMJQG -> sevensixthree
ZQIAGCVUDGSHG -> sevenfivenine
ZQIAGCVUDOSZG -> sevenfivefive
ZQIAGCVUDOMAT -> sevenfivefour
ZQIAGCVUDUWDW -> sevenfivezero
ZQIAGCPVQGSHG -> sevenfournine
ZQIAGCPVQOSZG -> sevenfourfive
ZQIAGCPVQOMAT -> sevenfourfour
ZQIAGCPVQUWDW -> sevenfourzero
ZQIAGOWYDPIMN -> seventhreesix
ZQIAGOWYDPHYW -> seventhreetwo
ZQIAGOWYDPMHG -> seventhreeone
ZQIAGOHBDLUNR -> seventwoeight
ZQIAGOHBPPFQX -> seventwoseven
ZQIAGOHBOMJQG -> seventwothree
ZQIAGTQLDLUNR -> sevenoneeight
ZQIAGTQLPPFQX -> sevenoneseven
ZQIAGTQLOMJQG -> sevenonethree
ZQIAGIZYTGSHG -> sevenzeronine
ZQIAGIZYTOSZG -> sevenzerofive
ZQIAGIZYTOMAT -> sevenzerofour
ZQIAGIZYTUWDW -> sevenzerozero
ZMGALBWWDLUNR -> sixeighteight
ZMGALBWWPPFQX -> sixeightseven
ZMGALBWWOMJQG -> sixeightthree
ZMGMPMZCDLUNR -> sixseveneight
ZMGMPMZCPPFQX -> sixsevenseven
ZMGMPMZCOMJQG -> sixseventhree
ZMGLMQZLDLUNR -> sixthreeeight
ZMGLMQZLPPFQX -> sixthreeseven
ZMGLMQZLOMJQG -> sixthreethree
MMIAGZQLDLUNR -> fivenineeight
MMIAGZQLPPFQX -> fivenineseven
MMIAGZQLOMJQG -> fiveninethree
MMIAPZXIOGSHG -> fiveeightnine
MMIAPZXIOOSZG -> fiveeightfive
MMIAPZXIOOMAT -> fiveeightfour
MMIAPZXIOUWDW -> fiveeightzero
MMIABDILUGSHG -> fivesevennine
MMIABDILUOSZG -> fivesevenfive
MMIABDILUOMAT -> fivesevenfour
MMIABDILUUWDW -> fivesevenzero
MMIAOZILDLUNR -> fivefiveeight
MMIAOZILPPFQX -> fivefiveseven
MMIAOZILOMJQG -> fivefivethree
MMIAOTJYDLUNR -> fivefoureight
MMIAOTJYPPFQX -> fivefourseven
MMIAOTJYOMJQG -> fivefourthree
MMIAAAMLDGSHG -> fivethreenine
MMIAAAMLDOSZG -> fivethreefive
MMIAAAMLDOMAT -> fivethreefour
MMIAAAMLDUWDW -> fivethreezero
MMIAUDMBDLUNR -> fivezeroeight
MMIAUDMBPPFQX -> fivezeroseven
MMIAUDMBOMJQG -> fivezerothree
MGJNGZQLDLUNR -> fournineeight
MGJNGZQLPPFQX -> fournineseven
MGJNGZQLOMJQG -> fourninethree
MGJNPZXIOGSHG -> foureightnine
MGJNPZXIOOSZG -> foureightfive
MGJNPZXIOOMAT -> foureightfour
MGJNPZXIOUWDW -> foureightzero
MGJNBDILUGSHG -> foursevennine
MGJNBDILUOSZG -> foursevenfive
MGJNBDILUOMAT -> foursevenfour
MGJNBDILUUWDW -> foursevenzero
MGJNOZILDLUNR -> fourfiveeight
MGJNOZILPPFQX -> fourfiveseven
MGJNOZILOMJQG -> fourfivethree
MGJNOTJYDLUNR -> fourfoureight
MGJNOTJYPPFQX -> fourfourseven
MGJNOTJYOMJQG -> fourfourthree
MGJNAAMLDGSHG -> fourthreenine
MGJNAAMLDOSZG -> fourthreefive
MGJNAAMLDOMAT -> fourthreefour
MGJNAAMLDUWDW -> fourthreezero
MGJNUDMBDLUNR -> fourzeroeight
MGJNUDMBPPFQX -> fourzeroseven
MGJNUDMBOMJQG -> fourzerothree
YNMAPUVCDGSHG -> threeninenine
YNMAPUVCDOSZG -> threeninefive
YNMAPUVCDOMAT -> threeninefour
YNMAPUVCDUWDW -> threeninezero
YNMAPDVJAAIMN -> threeeightsix
YNMAPDVJAAHYW -> threeeighttwo
YNMAPDVJAAMHG -> threeeightone
YNMAPPZUDGIMN -> threesevensix
YNMAPPZUDGHYW -> threeseventwo
YNMAPPZUDGMHG -> threesevenone
YNMAPPVSDLUNR -> threesixeight
YNMAPPVSPPFQX -> threesixseven
YNMAPPVSOMJQG -> threesixthree
YNMAPCVUDGSHG -> threefivenine
YNMAPCVUDOSZG -> threefivefive
YNMAPCVUDOMAT -> threefivefour
YNMAPCVUDUWDW -> threefivezero
YNMAPCPVQGSHG -> threefournine
YNMAPCPVQOSZG -> threefourfive
YNMAPCPVQOMAT -> threefourfour
YNMAPCPVQUWDW -> threefourzero
YNMAPOWYDPIMN -> threethreesix
YNMAPOWYDPHYW -> threethreetwo
YNMAPOWYDPMHG -> threethreeone
YNMAPOHBDLUNR -> threetwoeight
YNMAPOHBPPFQX -> threetwoseven
YNMAPOHBOMJQG -> threetwothree
YNMAPTQLDLUNR -> threeoneeight
YNMAPTQLPPFQX -> threeoneseven
YNMAPTQLOMJQG -> threeonethree
YNMAPIZYTGSHG -> threezeronine
YNMAPIZYTOSZG -> threezerofive
YNMAPIZYTOMAT -> threezerofour
YNMAPIZYTUWDW -> threezerozero
YYPALBWWDLUNR -> twoeighteight
YYPALBWWPPFQX -> twoeightseven
YYPALBWWOMJQG -> twoeightthree
YYPMPMZCDLUNR -> twoseveneight
YYPMPMZCPPFQX -> twosevenseven
YYPMPMZCOMJQG -> twoseventhree
YYPLMQZLDLUNR -> twothreeeight
YYPLMQZLPPFQX -> twothreeseven
YYPLMQZLOMJQG -> twothreethree
DHZALBWWDLUNR -> oneeighteight
DHZALBWWPPFQX -> oneeightseven
DHZALBWWOMJQG -> oneeightthree
DHZMPMZCDLUNR -> oneseveneight
DHZMPMZCPPFQX -> onesevenseven
DHZMPMZCOMJQG -> oneseventhree
DHZLMQZLDLUNR -> onethreeeight
DHZLMQZLPPFQX -> onethreeseven
DHZLMQZLOMJQG -> onethreethree
SQMQGZQLDLUNR -> zeronineeight
SQMQGZQLPPFQX -> zeronineseven
SQMQGZQLOMJQG -> zeroninethree
SQMQPZXIOGSHG -> zeroeightnine
SQMQPZXIOOSZG -> zeroeightfive
SQMQPZXIOOMAT -> zeroeightfour
SQMQPZXIOUWDW -> zeroeightzero
SQMQBDILUGSHG -> zerosevennine
SQMQBDILUOSZG -> zerosevenfive
SQMQBDILUOMAT -> zerosevenfour
SQMQBDILUUWDW -> zerosevenzero
SQMQOZILDLUNR -> zerofiveeight
SQMQOZILPPFQX -> zerofiveseven
SQMQOZILOMJQG -> zerofivethree
SQMQOTJYDLUNR -> zerofoureight
SQMQOTJYPPFQX -> zerofourseven
SQMQOTJYOMJQG -> zerofourthree
SQMQAAMLDGSHG -> zerothreenine
SQMQAAMLDOSZG -> zerothreefive
SQMQAAMLDOMAT -> zerothreefour
SQMQAAMLDUWDW -> zerothreezero
SQMQUDMBDLUNR -> zerozeroeight
SQMQUDMBPPFQX -> zerozeroseven
SQMQUDMBOMJQG -> zerozerothree

BUDRGDKNZWC -> nineninesix
BUDRGDKNYIL -> nineninetwo
BUDRGDKNDRV -> ninenineone
BUDRBDAEJRV -> ninesixnine
BUDRBDAMJJV -> ninesixfive
BUDRBDAMDKI -> ninesixfour
BUDRBDASNNL -> ninesixzero
BUDRODCNZWC -> ninefivesix
BUDRODCNYIL -> ninefivetwo
BUDRODCNDRV -> ninefiveone
BUDROXDAZWC -> ninefoursix
BUDROXDAYIL -> ninefourtwo
BUDROXDADRV -> ninefourone
BUDRAPJEJRV -> ninetwonine
BUDRAPJMJJV -> ninetwofive
BUDRAPJMDKI -> ninetwofour
BUDRAPJSNNL -> ninetwozero
BUDRFYTEJRV -> nineonenine
BUDRFYTMJJV -> nineonefive
BUDRFYTMDKI -> nineonefour
BUDRFYTSNNL -> nineonezero
BUDRUHGDZWC -> ninezerosix
BUDRUHGDYIL -> ninezerotwo
BUDRUHGDDRV -> ninezeroone
KUKOATPUZWC -> eightsixsix
KUKOATPUYIL -> eightsixtwo
KUKOATPUDRV -> eightsixone
KUKOASBDZWC -> eighttwosix
KUKOASBDYIL -> eighttwotwo
KUKOASBDDRV -> eighttwoone
KUKOAXKNZWC -> eightonesix
KUKOAXKNYIL -> eightonetwo
KUKOAXKNDRV -> eightoneone
WYVRGTPUZWC -> sevensixsix
WYVRGTPUYIL -> sevensixtwo
WYVRGTPUDRV -> sevensixone
WYVRGSBDZWC -> seventwosix
WYVRGSBDYIL -> seventwotwo
WYVRGSBDDRV -> seventwoone
WYVRGXKNZWC -> sevenonesix
WYVRGXKNYIL -> sevenonetwo
WYVRGXKNDRV -> sevenoneone
WUTILYTEJRV -> sixninenine
WUTILYTMJJV -> sixninefive
WUTILYTMDKI -> sixninefour
WUTILYTSNNL -> sixninezero
WUTRLFQYZWC -> sixeightsix
WUTRLFQYYIL -> sixeighttwo
WUTRLFQYDRV -> sixeightone
WUTDPQTEZWC -> sixsevensix
WUTDPQTEYIL -> sixseventwo
WUTDPQTEDRV -> sixsevenone
WUTDLOTJLXG -> sixsixeight
WUTDLOFNWAM -> sixsixseven
WUTDLOEKAAV -> sixsixthree
WUTQLQTEJRV -> sixfivenine
WUTQLQTMJJV -> sixfivefive
WUTQLQTMDKI -> sixfivefour
WUTQLQTSNNL -> sixfivezero
WUTQFRGEJRV -> sixfournine
WUTQFRGMJJV -> sixfourfive
WUTQFRGMDKI -> sixfourfour
WUTQFRGSNNL -> sixfourzero
WUTCMUTNZWC -> sixthreesix
WUTCMUTNYIL -> sixthreetwo
WUTCMUTNDRV -> sixthreeone
WUTCXXTJLXG -> sixtwoeight
WUTCXXFNWAM -> sixtwoseven
WUTCXXEKAAV -> sixtwothree
WUTHGHTJLXG -> sixoneeight
WUTHGHFNWAM -> sixoneseven
WUTHGHEKAAV -> sixonethree
WUTWPUJEJRV -> sixzeronine
WUTWPUJMJJV -> sixzerofive
WUTWPUJMDKI -> sixzerofour
WUTWPUJSNNL -> sixzerozero
JUVRGDKNZWC -> fiveninesix
JUVRGDKNYIL -> fiveninetwo
JUVRGDKNDRV -> fivenineone
JUVRBDAEJRV -> fivesixnine
JUVRBDAMJJV -> fivesixfive
JUVRBDAMDKI -> fivesixfour
JUVRBDASNNL -> fivesixzero
JUVRODCNZWC -> fivefivesix
JUVRODCNYIL -> fivefivetwo
JUVRODCNDRV -> fivefiveone
JUVROXDAZWC -> fivefoursix
JUVROXDAYIL -> fivefourtwo
JUVROXDADRV -> fivefourone
JUVRAPJEJRV -> fivetwonine
JUVRAPJMJJV -> fivetwofive
JUVRAPJMDKI -> fivetwofour
JUVRAPJSNNL -> fivetwozero
JUVRFYTEJRV -> fiveonenine
JUVRFYTMJJV -> fiveonefive
JUVRFYTMDKI -> fiveonefour
JUVRFYTSNNL -> fiveonezero
JUVRUHGDZWC -> fivezerosix
JUVRUHGDYIL -> fivezerotwo
JUVRUHGDDRV -> fivezeroone
JOWEGDKNZWC -> fourninesix
JOWEGDKNYIL -> fourninetwo
JOWEGDKNDRV -> fournineone
JOWEBDAEJRV -> foursixnine
JOWEBDAMJJV -> foursixfive
JOWEBDAMDKI -> foursixfour
JOWEBDASNNL -> foursixzero
JOWEODCNZWC -> fourfivesix
JOWEODCNYIL -> fourfivetwo
JOWEODCNDRV -> fourfiveone
JOWEOXDAZWC -> fourfoursix
JOWEOXDAYIL -> fourfourtwo
JOWEOXDADRV -> fourfourone
JOWEAPJEJRV -> fourtwonine
JOWEAPJMJJV -> fourtwofive
JOWEAPJMDKI -> fourtwofour
JOWEAPJSNNL -> fourtwozero
JOWEFYTEJRV -> fouronenine
JOWEFYTMJJV -> fouronefive
JOWEFYTMDKI -> fouronefour
JOWEFYTSNNL -> fouronezero
JOWEUHGDZWC -> fourzerosix
JOWEUHGDYIL -> fourzerotwo
JOWEUHGDDRV -> fourzeroone
VVZRPTPUZWC -> threesixsix
VVZRPTPUYIL -> threesixtwo
VVZRPTPUDRV -> threesixone
VVZRPSBDZWC -> threetwosix
VVZRPSBDYIL -> threetwotwo
VVZRPSBDDRV -> threetwoone
VVZRPXKNZWC -> threeonesix
VVZRPXKNYIL -> threeonetwo
VVZRPXKNDRV -> threeoneone
VGCILYTEJRV -> twoninenine
VGCILYTMJJV -> twoninefive
VGCILYTMDKI -> twoninefour
VGCILYTSNNL -> twoninezero
VGCRLFQYZWC -> twoeightsix
VGCRLFQYYIL -> twoeighttwo
VGCRLFQYDRV -> twoeightone
VGCDPQTEZWC -> twosevensix
VGCDPQTEYIL -> twoseventwo
VGCDPQTEDRV -> twosevenone
VGCDLOTJLXG -> twosixeight
VGCDLOFNWAM -> twosixseven
VGCDLOEKAAV -> twosixthree
VGCQLQTEJRV -> twofivenine
VGCQLQTMJJV -> twofivefive
VGCQLQTMDKI -> twofivefour
VGCQLQTSNNL -> twofivezero
VGCQFRGEJRV -> twofournine
VGCQFRGMJJV -> twofourfive
VGCQFRGMDKI -> twofourfour
VGCQFRGSNNL -> twofourzero
VGCCMUTNZWC -> twothreesix
VGCCMUTNYIL -> twothreetwo
VGCCMUTNDRV -> twothreeone
VGCCXXTJLXG -> twotwoeight
VGCCXXFNWAM -> twotwoseven
VGCCXXEKAAV -> twotwothree
VGCHGHTJLXG -> twooneeight
VGCHGHFNWAM -> twooneseven
VGCHGHEKAAV -> twoonethree
VGCWPUJEJRV -> twozeronine
VGCWPUJMJJV -> twozerofive
VGCWPUJMDKI -> twozerofour
VGCWPUJSNNL -> twozerozero
APMILYTEJRV -> oneninenine
APMILYTMJJV -> oneninefive
APMILYTMDKI -> oneninefour
APMILYTSNNL -> oneninezero
APMRLFQYZWC -> oneeightsix
APMRLFQYYIL -> oneeighttwo
APMRLFQYDRV -> oneeightone
APMDPQTEZWC -> onesevensix
APMDPQTEYIL -> oneseventwo
APMDPQTEDRV -> onesevenone
APMDLOTJLXG -> onesixeight
APMDLOFNWAM -> onesixseven
APMDLOEKAAV -> onesixthree
APMQLQTEJRV -> onefivenine
APMQLQTMJJV -> onefivefive
APMQLQTMDKI -> onefivefour
APMQLQTSNNL -> onefivezero
APMQFRGEJRV -> onefournine
APMQFRGMJJV -> onefourfive
APMQFRGMDKI -> onefourfour
APMQFRGSNNL -> onefourzero
APMCMUTNZWC -> onethreesix
APMCMUTNYIL -> onethreetwo
APMCMUTNDRV -> onethreeone
APMCXXTJLXG -> onetwoeight
APMCXXFNWAM -> onetwoseven
APMCXXEKAAV -> onetwothree
APMHGHTJLXG -> oneoneeight
APMHGHFNWAM -> oneoneseven
APMHGHEKAAV -> oneonethree
APMWPUJEJRV -> onezeronine
APMWPUJMJJV -> onezerofive
APMWPUJMDKI -> onezerofour
APMWPUJSNNL -> onezerozero
PYZHGDKNZWC -> zeroninesix
PYZHGDKNYIL -> zeroninetwo
PYZHGDKNDRV -> zeronineone
PYZHBDAEJRV -> zerosixnine
PYZHBDAMJJV -> zerosixfive
PYZHBDAMDKI -> zerosixfour
PYZHBDASNNL -> zerosixzero
PYZHODCNZWC -> zerofivesix
PYZHODCNYIL -> zerofivetwo
PYZHODCNDRV -> zerofiveone
PYZHOXDAZWC -> zerofoursix
PYZHOXDAYIL -> zerofourtwo
PYZHOXDADRV -> zerofourone
PYZHAPJEJRV -> zerotwonine
PYZHAPJMJJV -> zerotwofive
PYZHAPJMDKI -> zerotwofour
PYZHAPJSNNL -> zerotwozero
PYZHFYTEJRV -> zeroonenine
PYZHFYTMJJV -> zeroonefive
PYZHFYTMDKI -> zeroonefour
PYZHFYTSNNL -> zeroonezero
PYZHUHGDZWC -> zerozerosix
PYZHUHGDYIL -> zerozerotwo
PYZHUHGDDRV -> zerozeroone

QQBGLOFZQ -> sixsixsix
QQBGLOELZ -> sixsixtwo
QQBGLOJUJ -> sixsixone
QQBFXXFZQ -> sixtwosix
QQBFXXELZ -> sixtwotwo
QQBFXXJUJ -> sixtwoone
QQBKGHFZQ -> sixonesix
QQBKGHELZ -> sixonetwo
QQBKGHJUJ -> sixoneone
PCKGLOFZQ -> twosixsix
PCKGLOELZ -> twosixtwo
PCKGLOJUJ -> twosixone
PCKFXXFZQ -> twotwosix
PCKFXXELZ -> twotwotwo
PCKFXXJUJ -> twotwoone
PCKKGHFZQ -> twoonesix
PCKKGHELZ -> twoonetwo
PCKKGHJUJ -> twooneone
ULUGLOFZQ -> onesixsix
ULUGLOELZ -> onesixtwo
ULUGLOJUJ -> onesixone
ULUFXXFZQ -> onetwosix
ULUFXXELZ -> onetwotwo
ULUFXXJUJ -> onetwoone
ULUKGHFZQ -> oneonesix
ULUKGHELZ -> oneonetwo
ULUKGHJUJ -> oneoneone

FRRFEKEDDNRK -> nineninenine
FRRFEKEDLNJK -> nineninefive
FRRFEKEDLHKX -> nineninefour
FRRFEKEDRRNA -> nineninezero
FRRFNKLAXDWR -> nineeightsix
FRRFNKLAXCIA -> nineeighttwo
FRRFNKLAXHRK -> nineeightone
FRRFZOWDDDWR -> ninesevensix
FRRFZOWDDCIA -> nineseventwo
FRRFZOWDDHRK -> ninesevenone
FRRFZKUDIPXV -> ninesixeight
FRRFZKUPMAAB -> ninesixseven
FRRFZKUOJEAK -> ninesixthree
FRRFMKWDDNRK -> ninefivenine
FRRFMKWDLNJK -> ninefivefive
FRRFMKWDLHKX -> ninefivefour
FRRFMKWDRRNA -> ninefivezero
FRRFMEXQDNRK -> ninefournine
FRRFMEXQLNJK -> ninefourfive
FRRFMEXQLHKX -> ninefourfour
FRRFMEXQRRNA -> ninefourzero
FRRFYLADMDWR -> ninethreesix
FRRFYLADMCIA -> ninethreetwo
FRRFYLADMHRK -> ninethreeone
FRRFYWDDIPXV -> ninetwoeight
FRRFYWDPMAAB -> ninetwoseven
FRRFYWDOJEAK -> ninetwothree
FRRFDFNDIPXV -> nineoneeight
FRRFDFNPMAAB -> nineoneseven
FRRFDFNOJEAK -> nineonethree
FRRFSOATDNRK -> ninezeronine
FRRFSOATLNJK -> ninezerofive
FRRFSOATLHKX -> ninezerofour
FRRFSOATRRNA -> ninezerozero
ORYCYFJUMDWR -> eightninesix
ORYCYFJUMCIA -> eightninetwo
ORYCYFJUMHRK -> eightnineone
ORYCYAJKDNRK -> eightsixnine
ORYCYAJKLNJK -> eightsixfive
ORYCYAJKLHKX -> eightsixfour
ORYCYAJKRRNA -> eightsixzero
ORYCYNJMMDWR -> eightfivesix
ORYCYNJMMCIA -> eightfivetwo
ORYCYNJMMHRK -> eightfiveone
ORYCYNDNZDWR -> eightfoursix
ORYCYNDNZCIA -> eightfourtwo
ORYCYNDNZHRK -> eightfourone
ORYCYZVTDNRK -> eighttwonine
ORYCYZVTLNJK -> eighttwofive
ORYCYZVTLHKX -> eighttwofour
ORYCYZVTRRNA -> eighttwozero
ORYCYEEDDNRK -> eightonenine
ORYCYEEDLNJK -> eightonefive
ORYCYEEDLHKX -> eightonefour
ORYCYEEDRRNA -> eightonezero
ORYCYTNQCDWR -> eightzerosix
ORYCYTNQCCIA -> eightzerotwo
ORYCYTNQCHRK -> eightzeroone
AVJFEFJUMDWR -> sevenninesix
AVJFEFJUMCIA -> sevenninetwo
AVJFEFJUMHRK -> sevennineone
AVJFEAJKDNRK -> sevensixnine
AVJFEAJKLNJK -> sevensixfive
AVJFEAJKLHKX -> sevensixfour
AVJFEAJKRRNA -> sevensixzero
AVJFENJMMDWR -> sevenfivesix
AVJFENJMMCIA -> sevenfivetwo
AVJFENJMMHRK -> sevenfiveone
AVJFENDNZDWR -> sevenfoursix
AVJFENDNZCIA -> sevenfourtwo
AVJFENDNZHRK -> sevenfourone
AVJFEZVTDNRK -> seventwonine
AVJFEZVTLNJK -> seventwofive
AVJFEZVTLHKX -> seventwofour
AVJFEZVTRRNA -> seventwozero
AVJFEEEDDNRK -> sevenonenine
AVJFEEEDLNJK -> sevenonefive
AVJFEEEDLHKX -> sevenonefour
AVJFEEEDRRNA -> sevenonezero
AVJFETNQCDWR -> sevenzerosix
AVJFETNQCCIA -> sevenzerotwo
AVJFETNQCHRK -> sevenzeroone
ARHWJFNDIPXV -> sixnineeight
ARHWJFNPMAAB -> sixnineseven
ARHWJFNOJEAK -> sixninethree
ARHFJMKODNRK -> sixeightnine
ARHFJMKOLNJK -> sixeightfive
ARHFJMKOLHKX -> sixeightfour
ARHFJMKORRNA -> sixeightzero
ARHRNXNUDNRK -> sixsevennine
ARHRNXNULNJK -> sixsevenfive
ARHRNXNULHKX -> sixsevenfour
ARHRNXNURRNA -> sixsevenzero
ARHEJXNDIPXV -> sixfiveeight
ARHEJXNPMAAB -> sixfiveseven
ARHEJXNOJEAK -> sixfivethree
ARHEDYADIPXV -> sixfoureight
ARHEDYAPMAAB -> sixfourseven
ARHEDYAOJEAK -> sixfourthree
ARHQKBNDDNRK -> sixthreenine
ARHQKBNDLNJK -> sixthreefive
ARHQKBNDLHKX -> sixthreefour
ARHQKBNDRRNA -> sixthreezero
ARHKNBDDIPXV -> sixzeroeight
ARHKNBDPMAAB -> sixzeroseven
ARHKNBDOJEAK -> sixzerothree
NRJFEKEDDNRK -> fiveninenine
NRJFEKEDLNJK -> fiveninefive
NRJFEKEDLHKX -> fiveninefour
NRJFEKEDRRNA -> fiveninezero
NRJFNKLAXDWR -> fiveeightsix
NRJFNKLAXCIA -> fiveeighttwo
NRJFNKLAXHRK -> fiveeightone
NRJFZOWDDDWR -> fivesevensix
NRJFZOWDDCIA -> fiveseventwo
NRJFZOWDDHRK -> fivesevenone
NRJFZKUDIPXV -> fivesixeight
NRJFZKUPMAAB -> fivesixseven
NRJFZKUOJEAK -> fivesixthree
NRJFMKWDDNRK -> fivefivenine
NRJFMKWDLNJK -> fivefivefive
NRJFMKWDLHKX -> fivefivefour
NRJFMKWDRRNA -> fivefivezero
NRJFMEXQDNRK -> fivefournine
NRJFMEXQLNJK -> fivefourfive
NRJFMEXQLHKX -> fivefourfour
NRJFMEXQRRNA -> fivefourzero
NRJFYLADMDWR -> fivethreesix
NRJFYLADMCIA -> fivethreetwo
NRJFYLADMHRK -> fivethreeone
NRJFYWDDIPXV -> fivetwoeight
NRJFYWDPMAAB -> fivetwoseven
NRJFYWDOJEAK -> fivetwothree
NRJFDFNDIPXV -> fiveoneeight
NRJFDFNPMAAB -> fiveoneseven
NRJFDFNOJEAK -> fiveonethree
NRJFSOATDNRK -> fivezeronine
NRJFSOATLNJK -> fivezerofive
NRJFSOATLHKX -> fivezerofour
NRJFSOATRRNA -> fivezerozero
NLKSEKEDDNRK -> fourninenine
NLKSEKEDLNJK -> fourninefive
NLKSEKEDLHKX -> fourninefour
NLKSEKEDRRNA -> fourninezero
NLKSNKLAXDWR -> foureightsix
NLKSNKLAXCIA -> foureighttwo
NLKSNKLAXHRK -> foureightone
NLKSZOWDDDWR -> foursevensix
NLKSZOWDDCIA -> fourseventwo
NLKSZOWDDHRK -> foursevenone
NLKSZKUDIPXV -> foursixeight
NLKSZKUPMAAB -> foursixseven
NLKSZKUOJEAK -> foursixthree
NLKSMKWDDNRK -> fourfivenine
NLKSMKWDLNJK -> fourfivefive
NLKSMKWDLHKX -> fourfivefour
NLKSMKWDRRNA -> fourfivezero
NLKSMEXQDNRK -> fourfournine
NLKSMEXQLNJK -> fourfourfive
NLKSMEXQLHKX -> fourfourfour
NLKSMEXQRRNA -> fourfourzero
NLKSYLADMDWR -> fourthreesix
NLKSYLADMCIA -> fourthreetwo
NLKSYLADMHRK -> fourthreeone
NLKSYWDDIPXV -> fourtwoeight
NLKSYWDPMAAB -> fourtwoseven
NLKSYWDOJEAK -> fourtwothree
NLKSDFNDIPXV -> fouroneeight
NLKSDFNPMAAB -> fouroneseven
NLKSDFNOJEAK -> fouronethree
NLKSSOATDNRK -> fourzeronine
NLKSSOATLNJK -> fourzerofive
NLKSSOATLHKX -> fourzerofour
NLKSSOATRRNA -> fourzerozero
ZSNFNFJUMDWR -> threeninesix
ZSNFNFJUMCIA -> threeninetwo
ZSNFNFJUMHRK -> threenineone
ZSNFNAJKDNRK -> threesixnine
ZSNFNAJKLNJK -> threesixfive
ZSNFNAJKLHKX -> threesixfour
ZSNFNAJKRRNA -> threesixzero
ZSNFNNJMMDWR -> threefivesix
ZSNFNNJMMCIA -> threefivetwo
ZSNFNNJMMHRK -> threefiveone
ZSNFNNDNZDWR -> threefoursix
ZSNFNNDNZCIA -> threefourtwo
ZSNFNNDNZHRK -> threefourone
ZSNFNZVTDNRK -> threetwonine
ZSNFNZVTLNJK -> threetwofive
ZSNFNZVTLHKX -> threetwofour
ZSNFNZVTRRNA -> threetwozero
ZSNFNEEDDNRK -> threeonenine
ZSNFNEEDLNJK -> threeonefive
ZSNFNEEDLHKX -> threeonefour
ZSNFNEEDRRNA -> threeonezero
ZSNFNTNQCDWR -> threezerosix
ZSNFNTNQCCIA -> threezerotwo
ZSNFNTNQCHRK -> threezeroone
ZDQWJFNDIPXV -> twonineeight
ZDQWJFNPMAAB -> twonineseven
ZDQWJFNOJEAK -> twoninethree
ZDQFJMKODNRK -> twoeightnine
ZDQFJMKOLNJK -> twoeightfive
ZDQFJMKOLHKX -> twoeightfour
ZDQFJMKORRNA -> twoeightzero
ZDQRNXNUDNRK -> twosevennine
ZDQRNXNULNJK -> twosevenfive
ZDQRNXNULHKX -> twosevenfour
ZDQRNXNURRNA -> twosevenzero
ZDQEJXNDIPXV -> twofiveeight
ZDQEJXNPMAAB -> twofiveseven
ZDQEJXNOJEAK -> twofivethree
ZDQEDYADIPXV -> twofoureight
ZDQEDYAPMAAB -> twofourseven
ZDQEDYAOJEAK -> twofourthree
ZDQQKBNDDNRK -> twothreenine
ZDQQKBNDLNJK -> twothreefive
ZDQQKBNDLHKX -> twothreefour
ZDQQKBNDRRNA -> twothreezero
ZDQKNBDDIPXV -> twozeroeight
ZDQKNBDPMAAB -> twozeroseven
ZDQKNBDOJEAK -> twozerothree
EMAWJFNDIPXV -> onenineeight
EMAWJFNPMAAB -> onenineseven
EMAWJFNOJEAK -> oneninethree
EMAFJMKODNRK -> oneeightnine
EMAFJMKOLNJK -> oneeightfive
EMAFJMKOLHKX -> oneeightfour
EMAFJMKORRNA -> oneeightzero
EMARNXNUDNRK -> onesevennine
EMARNXNULNJK -> onesevenfive
EMARNXNULHKX -> onesevenfour
EMARNXNURRNA -> onesevenzero
EMAEJXNDIPXV -> onefiveeight
EMAEJXNPMAAB -> onefiveseven
EMAEJXNOJEAK -> onefivethree
EMAEDYADIPXV -> onefoureight
EMAEDYAPMAAB -> onefourseven
EMAEDYAOJEAK -> onefourthree
EMAQKBNDDNRK -> onethreenine
EMAQKBNDLNJK -> onethreefive
EMAQKBNDLHKX -> onethreefour
EMAQKBNDRRNA -> onethreezero
EMAKNBDDIPXV -> onezeroeight
EMAKNBDPMAAB -> onezeroseven
EMAKNBDOJEAK -> onezerothree
TVNVEKEDDNRK -> zeroninenine
TVNVEKEDLNJK -> zeroninefive
TVNVEKEDLHKX -> zeroninefour
TVNVEKEDRRNA -> zeroninezero
TVNVNKLAXDWR -> zeroeightsix
TVNVNKLAXCIA -> zeroeighttwo
TVNVNKLAXHRK -> zeroeightone
TVNVZOWDDDWR -> zerosevensix
TVNVZOWDDCIA -> zeroseventwo
TVNVZOWDDHRK -> zerosevenone
TVNVZKUDIPXV -> zerosixeight
TVNVZKUPMAAB -> zerosixseven
TVNVZKUOJEAK -> zerosixthree
TVNVMKWDDNRK -> zerofivenine
TVNVMKWDLNJK -> zerofivefive
TVNVMKWDLHKX -> zerofivefour
TVNVMKWDRRNA -> zerofivezero
TVNVMEXQDNRK -> zerofournine
TVNVMEXQLNJK -> zerofourfive
TVNVMEXQLHKX -> zerofourfour
TVNVMEXQRRNA -> zerofourzero
TVNVYLADMDWR -> zerothreesix
TVNVYLADMCIA -> zerothreetwo
TVNVYLADMHRK -> zerothreeone
TVNVYWDDIPXV -> zerotwoeight
TVNVYWDPMAAB -> zerotwoseven
TVNVYWDOJEAK -> zerotwothree
TVNVDFNDIPXV -> zerooneeight
TVNVDFNPMAAB -> zerooneseven
TVNVDFNOJEAK -> zeroonethree
TVNVSOATDNRK -> zerozeronine
TVNVSOATLNJK -> zerozerofive
TVNVSOATLHKX -> zerozerofour
TVNVSOATRRNA -> zerozerozero

XBLKRFROUVVABI -> nineeighteight
XBLKRFROUHZLEO -> nineeightseven
XBLKRFROUGWPEX -> nineeightthree
XBLKDJCRAVVABI -> nineseveneight
XBLKDJCRAHZLEO -> ninesevenseven
XBLKDJCRAGWPEX -> nineseventhree
XBLKCGGRJVVABI -> ninethreeeight
XBLKCGGRJHZLEO -> ninethreeseven
XBLKCGGRJGWPEX -> ninethreethree
GBSHCAPIJVVABI -> eightnineeight
GBSHCAPIJHZLEO -> eightnineseven
GBSHCAPIJGWPEX -> eightninethree
GBSHCJPPGGQYVX -> eighteightnine
GBSHCJPPGGYYNX -> eighteightfive
GBSHCJPPGGYSOK -> eighteightfour
GBSHCJPPGGECRN -> eighteightzero
GBSHCVTAJMQYVX -> eightsevennine
GBSHCVTAJMYYNX -> eightsevenfive
GBSHCVTAJMYSOK -> eightsevenfour
GBSHCVTAJMECRN -> eightsevenzero
GBSHCIPAJVVABI -> eightfiveeight
GBSHCIPAJHZLEO -> eightfiveseven
GBSHCIPAJGWPEX -> eightfivethree
GBSHCIJBWVVABI -> eightfoureight
GBSHCIJBWHZLEO -> eightfourseven
GBSHCIJBWGWPEX -> eightfourthree
GBSHCUQEJVQYVX -> eightthreenine
GBSHCUQEJVYYNX -> eightthreefive
GBSHCUQEJVYSOK -> eightthreefour
GBSHCUQEJVECRN -> eightthreezero
GBSHCOTEZVVABI -> eightzeroeight
GBSHCOTEZHZLEO -> eightzeroseven
GBSHCOTEZGWPEX -> eightzerothree
SFDKIAPIJVVABI -> sevennineeight
SFDKIAPIJHZLEO -> sevennineseven
SFDKIAPIJGWPEX -> sevenninethree
SFDKIJPPGGQYVX -> seveneightnine
SFDKIJPPGGYYNX -> seveneightfive
SFDKIJPPGGYSOK -> seveneightfour
SFDKIJPPGGECRN -> seveneightzero
SFDKIVTAJMQYVX -> sevensevennine
SFDKIVTAJMYYNX -> sevensevenfive
SFDKIVTAJMYSOK -> sevensevenfour
SFDKIVTAJMECRN -> sevensevenzero
SFDKIIPAJVVABI -> sevenfiveeight
SFDKIIPAJHZLEO -> sevenfiveseven
SFDKIIPAJGWPEX -> sevenfivethree
SFDKIIJBWVVABI -> sevenfoureight
SFDKIIJBWHZLEO -> sevenfourseven
SFDKIIJBWGWPEX -> sevenfourthree
SFDKIUQEJVQYVX -> seventhreenine
SFDKIUQEJVYYNX -> seventhreefive
SFDKIUQEJVYSOK -> seventhreefour
SFDKIUQEJVECRN -> seventhreezero
SFDKIOTEZVVABI -> sevenzeroeight
SFDKIOTEZHZLEO -> sevenzeroseven
SFDKIOTEZGWPEX -> sevenzerothree
FBDKRFROUVVABI -> fiveeighteight
FBDKRFROUHZLEO -> fiveeightseven
FBDKRFROUGWPEX -> fiveeightthree
FBDKDJCRAVVABI -> fiveseveneight
FBDKDJCRAHZLEO -> fivesevenseven
FBDKDJCRAGWPEX -> fiveseventhree
FBDKCGGRJVVABI -> fivethreeeight
FBDKCGGRJHZLEO -> fivethreeseven
FBDKCGGRJGWPEX -> fivethreethree
FVEXRFROUVVABI -> foureighteight
FVEXRFROUHZLEO -> foureightseven
FVEXRFROUGWPEX -> foureightthree
FVEXDJCRAVVABI -> fourseveneight
FVEXDJCRAHZLEO -> foursevenseven
FVEXDJCRAGWPEX -> fourseventhree
FVEXCGGRJVVABI -> fourthreeeight
FVEXCGGRJHZLEO -> fourthreeseven
FVEXCGGRJGWPEX -> fourthreethree
RCHKRAPIJVVABI -> threenineeight
RCHKRAPIJHZLEO -> threenineseven
RCHKRAPIJGWPEX -> threeninethree
RCHKRJPPGGQYVX -> threeeightnine
RCHKRJPPGGYYNX -> threeeightfive
RCHKRJPPGGYSOK -> threeeightfour
RCHKRJPPGGECRN -> threeeightzero
RCHKRVTAJMQYVX -> threesevennine
RCHKRVTAJMYYNX -> threesevenfive
RCHKRVTAJMYSOK -> threesevenfour
RCHKRVTAJMECRN -> threesevenzero
RCHKRIPAJVVABI -> threefiveeight
RCHKRIPAJHZLEO -> threefiveseven
RCHKRIPAJGWPEX -> threefivethree
RCHKRIJBWVVABI -> threefoureight
RCHKRIJBWHZLEO -> threefourseven
RCHKRIJBWGWPEX -> threefourthree
RCHKRUQEJVQYVX -> threethreenine
RCHKRUQEJVYYNX -> threethreefive
RCHKRUQEJVYSOK -> threethreefour
RCHKRUQEJVECRN -> threethreezero
RCHKROTEZVVABI -> threezeroeight
RCHKROTEZHZLEO -> threezeroseven
RCHKROTEZGWPEX -> threezerothree
LFHARFROUVVABI -> zeroeighteight
LFHARFROUHZLEO -> zeroeightseven
LFHARFROUGWPEX -> zeroeightthree
LFHADJCRAVVABI -> zeroseveneight
LFHADJCRAHZLEO -> zerosevenseven
LFHADJCRAGWPEX -> zeroseventhree
LFHACGGRJVVABI -> zerothreeeight
LFHACGGRJHZLEO -> zerothreeseven
LFHACGGRJGWPEX -> zerothreethree

OWHHGPMPUI -> ninesixsix
OWHHGPMOGR -> ninesixtwo
OWHHGPMTPB -> ninesixone
OWHHFBVPUI -> ninetwosix
OWHHFBVOGR -> ninetwotwo
OWHHFBVTPB -> ninetwoone
OWHHKKFPUI -> nineonesix
OWHHKKFOGR -> nineonetwo
OWHHKKFTPB -> nineoneone
JWXYQKFPUI -> sixninesix
JWXYQKFOGR -> sixninetwo
JWXYQKFTPB -> sixnineone
JWXTQAWZPB -> sixsixnine
JWXTQAEZHB -> sixsixfive
JWXTQAETIO -> sixsixfour
JWXTQAKDLR -> sixsixzero
JWXGQCFPUI -> sixfivesix
JWXGQCFOGR -> sixfivetwo
JWXGQCFTPB -> sixfiveone
JWXGKDSPUI -> sixfoursix
JWXGKDSOGR -> sixfourtwo
JWXGKDSTPB -> sixfourone
JWXSCJWZPB -> sixtwonine
JWXSCJEZHB -> sixtwofive
JWXSCJETIO -> sixtwofour
JWXSCJKDLR -> sixtwozero
JWXXLTWZPB -> sixonenine
JWXXLTEZHB -> sixonefive
JWXXLTETIO -> sixonefour
JWXXLTKDLR -> sixonezero
JWXMUGVPUI -> sixzerosix
JWXMUGVOGR -> sixzerotwo
JWXMUGVTPB -> sixzeroone
WWZHGPMPUI -> fivesixsix
WWZHGPMOGR -> fivesixtwo
WWZHGPMTPB -> fivesixone
WWZHFBVPUI -> fivetwosix
WWZHFBVOGR -> fivetwotwo
WWZHFBVTPB -> fivetwoone
WWZHKKFPUI -> fiveonesix
WWZHKKFOGR -> fiveonetwo
WWZHKKFTPB -> fiveoneone
WQAUGPMPUI -> foursixsix
WQAUGPMOGR -> foursixtwo
WQAUGPMTPB -> foursixone
WQAUFBVPUI -> fourtwosix
WQAUFBVOGR -> fourtwotwo
WQAUFBVTPB -> fourtwoone
WQAUKKFPUI -> fouronesix
WQAUKKFOGR -> fouronetwo
WQAUKKFTPB -> fouroneone
IIGYQKFPUI -> twoninesix
IIGYQKFOGR -> twoninetwo
IIGYQKFTPB -> twonineone
IIGTQAWZPB -> twosixnine
IIGTQAEZHB -> twosixfive
IIGTQAETIO -> twosixfour
IIGTQAKDLR -> twosixzero
IIGGQCFPUI -> twofivesix
IIGGQCFOGR -> twofivetwo
IIGGQCFTPB -> twofiveone
IIGGKDSPUI -> twofoursix
IIGGKDSOGR -> twofourtwo
IIGGKDSTPB -> twofourone
IIGSCJWZPB -> twotwonine
IIGSCJEZHB -> twotwofive
IIGSCJETIO -> twotwofour
IIGSCJKDLR -> twotwozero
IIGXLTWZPB -> twoonenine
IIGXLTEZHB -> twoonefive
IIGXLTETIO -> twoonefour
IIGXLTKDLR -> twoonezero
IIGMUGVPUI -> twozerosix
IIGMUGVOGR -> twozerotwo
IIGMUGVTPB -> twozeroone
NRQYQKFPUI -> oneninesix
NRQYQKFOGR -> oneninetwo
NRQYQKFTPB -> onenineone
NRQTQAWZPB -> onesixnine
NRQTQAEZHB -> onesixfive
NRQTQAETIO -> onesixfour
NRQTQAKDLR -> onesixzero
NRQGQCFPUI -> onefivesix
NRQGQCFOGR -> onefivetwo
NRQGQCFTPB -> onefiveone
NRQGKDSPUI -> onefoursix
NRQGKDSOGR -> onefourtwo
NRQGKDSTPB -> onefourone
NRQSCJWZPB -> onetwonine
NRQSCJEZHB -> onetwofive
NRQSCJETIO -> onetwofour
NRQSCJKDLR -> onetwozero
NRQXLTWZPB -> oneonenine
NRQXLTEZHB -> oneonefive
NRQXLTETIO -> oneonefour
NRQXLTKDLR -> oneonezero
NRQMUGVPUI -> onezerosix
NRQMUGVOGR -> onezerotwo
NRQMUGVTPB -> onezeroone
CADXGPMPUI -> zerosixsix
CADXGPMOGR -> zerosixtwo
CADXGPMTPB -> zerosixone
CADXFBVPUI -> zerotwosix
CADXFBVOGR -> zerotwotwo
CADXFBVTPB -> zerotwoone
CADXKKFPUI -> zeroonesix
CADXKKFOGR -> zeroonetwo
CADXKKFTPB -> zerooneone

DAOQFPNGSU -> ninesixsix
DAOQFPNFED -> ninesixtwo
DAOQFPNKNN -> ninesixone
DAOQEBWGSU -> ninetwosix
DAOQEBWFED -> ninetwotwo
DAOQEBWKNN -> ninetwoone
DAOQJKGGSU -> nineonesix
DAOQJKGFED -> nineonetwo
DAOQJKGKNN -> nineoneone
YAEHPKGGSU -> sixninesix
YAEHPKGFED -> sixninetwo
YAEHPKGKNN -> sixnineone
YAECPAXQNN -> sixsixnine
YAECPAFQFN -> sixsixfive
YAECPAFKGA -> sixsixfour
YAECPALUJD -> sixsixzero
YAEPPCGGSU -> sixfivesix
YAEPPCGFED -> sixfivetwo
YAEPPCGKNN -> sixfiveone
YAEPJDTGSU -> sixfoursix
YAEPJDTFED -> sixfourtwo
YAEPJDTKNN -> sixfourone
YAEBBJXQNN -> sixtwonine
YAEBBJFQFN -> sixtwofive
YAEBBJFKGA -> sixtwofour
YAEBBJLUJD -> sixtwozero
YAEGKTXQNN -> sixonenine
YAEGKTFQFN -> sixonefive
YAEGKTFKGA -> sixonefour
YAEGKTLUJD -> sixonezero
YAEVTGWGSU -> sixzerosix
YAEVTGWFED -> sixzerotwo
YAEVTGWKNN -> sixzeroone
LAGQFPNGSU -> fivesixsix
LAGQFPNFED -> fivesixtwo
LAGQFPNKNN -> fivesixone
LAGQEBWGSU -> fivetwosix
LAGQEBWFED -> fivetwotwo
LAGQEBWKNN -> fivetwoone
LAGQJKGGSU -> fiveonesix
LAGQJKGFED -> fiveonetwo
LAGQJKGKNN -> fiveoneone
LUHDFPNGSU -> foursixsix
LUHDFPNFED -> foursixtwo
LUHDFPNKNN -> foursixone
LUHDEBWGSU -> fourtwosix
LUHDEBWFED -> fourtwotwo
LUHDEBWKNN -> fourtwoone
LUHDJKGGSU -> fouronesix
LUHDJKGFED -> fouronetwo
LUHDJKGKNN -> fouroneone
XMNHPKGGSU -> twoninesix
XMNHPKGFED -> twoninetwo
XMNHPKGKNN -> twonineone
XMNCPAXQNN -> twosixnine
XMNCPAFQFN -> twosixfive
XMNCPAFKGA -> twosixfour
XMNCPALUJD -> twosixzero
XMNPPCGGSU -> twofivesix
XMNPPCGFED -> twofivetwo
XMNPPCGKNN -> twofiveone
XMNPJDTGSU -> twofoursix
XMNPJDTFED -> twofourtwo
XMNPJDTKNN -> twofourone
XMNBBJXQNN -> twotwonine
XMNBBJFQFN -> twotwofive
XMNBBJFKGA -> twotwofour
XMNBBJLUJD -> twotwozero
XMNGKTXQNN -> twoonenine
XMNGKTFQFN -> twoonefive
XMNGKTFKGA -> twoonefour
XMNGKTLUJD -> twoonezero
XMNVTGWGSU -> twozerosix
XMNVTGWFED -> twozerotwo
XMNVTGWKNN -> twozeroone
CVXHPKGGSU -> oneninesix
CVXHPKGFED -> oneninetwo
CVXHPKGKNN -> onenineone
CVXCPAXQNN -> onesixnine
CVXCPAFQFN -> onesixfive
CVXCPAFKGA -> onesixfour
CVXCPALUJD -> onesixzero
CVXPPCGGSU -> onefivesix
CVXPPCGFED -> onefivetwo
CVXPPCGKNN -> onefiveone
CVXPJDTGSU -> onefoursix
CVXPJDTFED -> onefourtwo
CVXPJDTKNN -> onefourone
CVXBBJXQNN -> onetwonine
CVXBBJFQFN -> onetwofive
CVXBBJFKGA -> onetwofour
CVXBBJLUJD -> onetwozero
CVXGKTXQNN -> oneonenine
CVXGKTFQFN -> oneonefive
CVXGKTFKGA -> oneonefour
CVXGKTLUJD -> oneonezero
CVXVTGWGSU -> onezerosix
CVXVTGWFED -> onezerotwo
CVXVTGWKNN -> onezeroone
REKGFPNGSU -> zerosixsix
REKGFPNFED -> zerosixtwo
REKGFPNKNN -> zerosixone
REKGEBWGSU -> zerotwosix
REKGEBWFED -> zerotwotwo
REKGEBWKNN -> zerotwoone
REKGJKGGSU -> zeroonesix
REKGJKGFED -> zeroonetwo
REKGJKGKNN -> zerooneone

ASIHGZBVDYAJB -> ninenineeight
ASIHGZBVPCLMH -> ninenineseven
ASIHGZBVOZPMQ -> nineninethree
ASIHPZISOTYDQ -> nineeightnine
ASIHPZISOBYVQ -> nineeightfive
ASIHPZISOBSWD -> nineeightfour
ASIHPZISOHCZG -> nineeightzero
ASIHBDTVUTYDQ -> ninesevennine
ASIHBDTVUBYVQ -> ninesevenfive
ASIHBDTVUBSWD -> ninesevenfour
ASIHBDTVUHCZG -> ninesevenzero
ASIHOZTVDYAJB -> ninefiveeight
ASIHOZTVPCLMH -> ninefiveseven
ASIHOZTVOZPMQ -> ninefivethree
ASIHOTUIDYAJB -> ninefoureight
ASIHOTUIPCLMH -> ninefourseven
ASIHOTUIOZPMQ -> ninefourthree
ASIHAAXVDTYDQ -> ninethreenine
ASIHAAXVDBYVQ -> ninethreefive
ASIHAAXVDBSWD -> ninethreefour
ASIHAAXVDHCZG -> ninethreezero
ASIHUDXLDYAJB -> ninezeroeight
ASIHUDXLPCLMH -> ninezeroseven
ASIHUDXLOZPMQ -> ninezerothree
JSPEAUGMDTYDQ -> eightninenine
JSPEAUGMDBYVQ -> eightninefive
JSPEAUGMDBSWD -> eightninefour
JSPEAUGMDHCZG -> eightninezero
JSPEADGTANOIX -> eighteightsix
JSPEADGTANNUG -> eighteighttwo
JSPEADGTANSDQ -> eighteightone
JSPEAPKEDTOIX -> eightsevensix
JSPEAPKEDTNUG -> eightseventwo
JSPEAPKEDTSDQ -> eightsevenone
JSPEAPGCDYAJB -> eightsixeight
JSPEAPGCPCLMH -> eightsixseven
JSPEAPGCOZPMQ -> eightsixthree
JSPEACGEDTYDQ -> eightfivenine
JSPEACGEDBYVQ -> eightfivefive
JSPEACGEDBSWD -> eightfivefour
JSPEACGEDHCZG -> eightfivezero
JSPEACAFQTYDQ -> eightfournine
JSPEACAFQBYVQ -> eightfourfive
JSPEACAFQBSWD -> eightfourfour
JSPEACAFQHCZG -> eightfourzero
JSPEAOHIDCOIX -> eightthreesix
JSPEAOHIDCNUG -> eightthreetwo
JSPEAOHIDCSDQ -> eightthreeone
JSPEAOSLDYAJB -> eighttwoeight
JSPEAOSLPCLMH -> eighttwoseven
JSPEAOSLOZPMQ -> eighttwothree
JSPEATBVDYAJB -> eightoneeight
JSPEATBVPCLMH -> eightoneseven
JSPEATBVOZPMQ -> eightonethree
JSPEAIKITTYDQ -> eightzeronine
JSPEAIKITBYVQ -> eightzerofive
JSPEAIKITBSWD -> eightzerofour
JSPEAIKITHCZG -> eightzerozero
VWAHGUGMDTYDQ -> sevenninenine
VWAHGUGMDBYVQ -> sevenninefive
VWAHGUGMDBSWD -> sevenninefour
VWAHGUGMDHCZG -> sevenninezero
VWAHGDGTANOIX -> seveneightsix
VWAHGDGTANNUG -> seveneighttwo
VWAHGDGTANSDQ -> seveneightone
VWAHGPKEDTOIX -> sevensevensix
VWAHGPKEDTNUG -> sevenseventwo
VWAHGPKEDTSDQ -> sevensevenone
VWAHGPGCDYAJB -> sevensixeight
VWAHGPGCPCLMH -> sevensixseven
VWAHGPGCOZPMQ -> sevensixthree
VWAHGCGEDTYDQ -> sevenfivenine
VWAHGCGEDBYVQ -> sevenfivefive
VWAHGCGEDBSWD -> sevenfivefour
VWAHGCGEDHCZG -> sevenfivezero
VWAHGCAFQTYDQ -> sevenfournine
VWAHGCAFQBYVQ -> sevenfourfive
VWAHGCAFQBSWD -> sevenfourfour
VWAHGCAFQHCZG -> sevenfourzero
VWAHGOHIDCOIX -> seventhreesix
VWAHGOHIDCNUG -> seventhreetwo
VWAHGOHIDCSDQ -> seventhreeone
VWAHGOSLDYAJB -> seventwoeight
VWAHGOSLPCLMH -> seventwoseven
VWAHGOSLOZPMQ -> seventwothree
VWAHGTBVDYAJB -> sevenoneeight
VWAHGTBVPCLMH -> sevenoneseven
VWAHGTBVOZPMQ -> sevenonethree
VWAHGIKITTYDQ -> sevenzeronine
VWAHGIKITBYVQ -> sevenzerofive
VWAHGIKITBSWD -> sevenzerofour
VWAHGIKITHCZG -> sevenzerozero
VSYHLBHGDYAJB -> sixeighteight
VSYHLBHGPCLMH -> sixeightseven
VSYHLBHGOZPMQ -> sixeightthree
VSYTPMKMDYAJB -> sixseveneight
VSYTPMKMPCLMH -> sixsevenseven
VSYTPMKMOZPMQ -> sixseventhree
VSYSMQKVDYAJB -> sixthreeeight
VSYSMQKVPCLMH -> sixthreeseven
VSYSMQKVOZPMQ -> sixthreethree
ISAHGZBVDYAJB -> fivenineeight
ISAHGZBVPCLMH -> fivenineseven
ISAHGZBVOZPMQ -> fiveninethree
ISAHPZISOTYDQ -> fiveeightnine
ISAHPZISOBYVQ -> fiveeightfive
ISAHPZISOBSWD -> fiveeightfour
ISAHPZISOHCZG -> fiveeightzero
ISAHBDTVUTYDQ -> fivesevennine
ISAHBDTVUBYVQ -> fivesevenfive
ISAHBDTVUBSWD -> fivesevenfour
ISAHBDTVUHCZG -> fivesevenzero
ISAHOZTVDYAJB -> fivefiveeight
ISAHOZTVPCLMH -> fivefiveseven
ISAHOZTVOZPMQ -> fivefivethree
ISAHOTUIDYAJB -> fivefoureight
ISAHOTUIPCLMH -> fivefourseven
ISAHOTUIOZPMQ -> fivefourthree
ISAHAAXVDTYDQ -> fivethreenine
ISAHAAXVDBYVQ -> fivethreefive
ISAHAAXVDBSWD -> fivethreefour
ISAHAAXVDHCZG -> fivethreezero
ISAHUDXLDYAJB -> fivezeroeight
ISAHUDXLPCLMH -> fivezeroseven
ISAHUDXLOZPMQ -> fivezerothree
IMBUGZBVDYAJB -> fournineeight
IMBUGZBVPCLMH -> fournineseven
IMBUGZBVOZPMQ -> fourninethree
IMBUPZISOTYDQ -> foureightnine
IMBUPZISOBYVQ -> foureightfive
IMBUPZISOBSWD -> foureightfour
IMBUPZISOHCZG -> foureightzero
IMBUBDTVUTYDQ -> foursevennine
IMBUBDTVUBYVQ -> foursevenfive
IMBUBDTVUBSWD -> foursevenfour
IMBUBDTVUHCZG -> foursevenzero
IMBUOZTVDYAJB -> fourfiveeight
IMBUOZTVPCLMH -> fourfiveseven
IMBUOZTVOZPMQ -> fourfivethree
IMBUOTUIDYAJB -> fourfoureight
IMBUOTUIPCLMH -> fourfourseven
IMBUOTUIOZPMQ -> fourfourthree
IMBUAAXVDTYDQ -> fourthreenine
IMBUAAXVDBYVQ -> fourthreefive
IMBUAAXVDBSWD -> fourthreefour
IMBUAAXVDHCZG -> fourthreezero
IMBUUDXLDYAJB -> fourzeroeight
IMBUUDXLPCLMH -> fourzeroseven
IMBUUDXLOZPMQ -> fourzerothree
UTEHPUGMDTYDQ -> threeninenine
UTEHPUGMDBYVQ -> threeninefive
UTEHPUGMDBSWD -> threeninefour
UTEHPUGMDHCZG -> threeninezero
UTEHPDGTANOIX -> threeeightsix
UTEHPDGTANNUG -> threeeighttwo
UTEHPDGTANSDQ -> threeeightone
UTEHPPKEDTOIX -> threesevensix
UTEHPPKEDTNUG -> threeseventwo
UTEHPPKEDTSDQ -> threesevenone
UTEHPPGCDYAJB -> threesixeight
UTEHPPGCPCLMH -> threesixseven
UTEHPPGCOZPMQ -> threesixthree
UTEHPCGEDTYDQ -> threefivenine
UTEHPCGEDBYVQ -> threefivefive
UTEHPCGEDBSWD -> threefivefour
UTEHPCGEDHCZG -> threefivezero
UTEHPCAFQTYDQ -> threefournine
UTEHPCAFQBYVQ -> threefourfive
UTEHPCAFQBSWD -> threefourfour
UTEHPCAFQHCZG -> threefourzero
UTEHPOHIDCOIX -> threethreesix
UTEHPOHIDCNUG -> threethreetwo
UTEHPOHIDCSDQ -> threethreeone
UTEHPOSLDYAJB -> threetwoeight
UTEHPOSLPCLMH -> threetwoseven
UTEHPOSLOZPMQ -> threetwothree
UTEHPTBVDYAJB -> threeoneeight
UTEHPTBVPCLMH -> threeoneseven
UTEHPTBVOZPMQ -> threeonethree
UTEHPIKITTYDQ -> threezeronine
UTEHPIKITBYVQ -> threezerofive
UTEHPIKITBSWD -> threezerofour
UTEHPIKITHCZG -> threezerozero
UEHHLBHGDYAJB -> twoeighteight
UEHHLBHGPCLMH -> twoeightseven
UEHHLBHGOZPMQ -> twoeightthree
UEHTPMKMDYAJB -> twoseveneight
UEHTPMKMPCLMH -> twosevenseven
UEHTPMKMOZPMQ -> twoseventhree
UEHSMQKVDYAJB -> twothreeeight
UEHSMQKVPCLMH -> twothreeseven
UEHSMQKVOZPMQ -> twothreethree
ZNRHLBHGDYAJB -> oneeighteight
ZNRHLBHGPCLMH -> oneeightseven
ZNRHLBHGOZPMQ -> oneeightthree
ZNRTPMKMDYAJB -> oneseveneight
ZNRTPMKMPCLMH -> onesevenseven
ZNRTPMKMOZPMQ -> oneseventhree
ZNRSMQKVDYAJB -> onethreeeight
ZNRSMQKVPCLMH -> onethreeseven
ZNRSMQKVOZPMQ -> onethreethree
OWEXGZBVDYAJB -> zeronineeight
OWEXGZBVPCLMH -> zeronineseven
OWEXGZBVOZPMQ -> zeroninethree
OWEXPZISOTYDQ -> zeroeightnine
OWEXPZISOBYVQ -> zeroeightfive
OWEXPZISOBSWD -> zeroeightfour
OWEXPZISOHCZG -> zeroeightzero
OWEXBDTVUTYDQ -> zerosevennine
OWEXBDTVUBYVQ -> zerosevenfive
OWEXBDTVUBSWD -> zerosevenfour
OWEXBDTVUHCZG -> zerosevenzero
OWEXOZTVDYAJB -> zerofiveeight
OWEXOZTVPCLMH -> zerofiveseven
OWEXOZTVOZPMQ -> zerofivethree
OWEXOTUIDYAJB -> zerofoureight
OWEXOTUIPCLMH -> zerofourseven
OWEXOTUIOZPMQ -> zerofourthree
OWEXAAXVDTYDQ -> zerothreenine
OWEXAAXVDBYVQ -> zerothreefive
OWEXAAXVDBSWD -> zerothreefour
OWEXAAXVDHCZG -> zerothreezero
OWEXUDXLDYAJB -> zerozeroeight
OWEXUDXLPCLMH -> zerozeroseven
OWEXUDXLOZPMQ -> zerozerothree

OUQIGDPLCPJXJYT -> eighteighteight
OUQIGDPLCPVBUBZ -> eighteightseven
OUQIGDPLCPUYYBI -> eighteightthree
OUQIGPTWFVJXJYT -> eightseveneight
OUQIGPTWFVVBUBZ -> eightsevenseven
OUQIGPTWFVUYYBI -> eightseventhree
OUQIGOQAFEJXJYT -> eightthreeeight
OUQIGOQAFEVBUBZ -> eightthreeseven
OUQIGOQAFEUYYBI -> eightthreethree
AYBLMDPLCPJXJYT -> seveneighteight
AYBLMDPLCPVBUBZ -> seveneightseven
AYBLMDPLCPUYYBI -> seveneightthree
AYBLMPTWFVJXJYT -> sevenseveneight
AYBLMPTWFVVBUBZ -> sevensevenseven
AYBLMPTWFVUYYBI -> sevenseventhree
AYBLMOQAFEJXJYT -> seventhreeeight
AYBLMOQAFEVBUBZ -> seventhreeseven
AYBLMOQAFEUYYBI -> seventhreethree
ZVFLVDPLCPJXJYT -> threeeighteight
ZVFLVDPLCPVBUBZ -> threeeightseven
ZVFLVDPLCPUYYBI -> threeeightthree
ZVFLVPTWFVJXJYT -> threeseveneight
ZVFLVPTWFVVBUBZ -> threesevenseven
ZVFLVPTWFVUYYBI -> threeseventhree
ZVFLVOQAFEJXJYT -> threethreeeight
ZVFLVOQAFEVBUBZ -> threethreeseven
ZVFLVOQAFEUYYBI -> threethreethree

XNZYGDQYZ -> sixsixsix
XNZYGDPKI -> sixsixtwo
XNZYGDUTS -> sixsixone
XNZXSMQYZ -> sixtwosix
XNZXSMPKI -> sixtwotwo
XNZXSMUTS -> sixtwoone
XNZCBWQYZ -> sixonesix
XNZCBWPKI -> sixonetwo
XNZCBWUTS -> sixoneone
WZIYGDQYZ -> twosixsix
WZIYGDPKI -> twosixtwo
WZIYGDUTS -> twosixone
WZIXSMQYZ -> twotwosix
WZIXSMPKI -> twotwotwo
WZIXSMUTS -> twotwoone
WZICBWQYZ -> twoonesix
WZICBWPKI -> twoonetwo
WZICBWUTS -> twooneone
BISYGDQYZ -> onesixsix
BISYGDPKI -> onesixtwo
BISYGDUTS -> onesixone
BISXSMQYZ -> onetwosix
BISXSMPKI -> onetwotwo
BISXSMUTS -> onetwoone
BISCBWQYZ -> oneonesix
BISCBWPKI -> oneonetwo
BISCBWUTS -> oneoneone

PDLBFVHRQV -> ninesixsix
PDLBFVHQCE -> ninesixtwo
PDLBFVHVLO -> ninesixone
PDLBEHQRQV -> ninetwosix
PDLBEHQQCE -> ninetwotwo
PDLBEHQVLO -> ninetwoone
PDLBJQARQV -> nineonesix
PDLBJQAQCE -> nineonetwo
PDLBJQAVLO -> nineoneone
KDBSPQARQV -> sixninesix
KDBSPQAQCE -> sixninetwo
KDBSPQAVLO -> sixnineone
KDBNPGRBLO -> sixsixnine
KDBNPGZBDO -> sixsixfive
KDBNPGZVEB -> sixsixfour
KDBNPGFFHE -> sixsixzero
KDBAPIARQV -> sixfivesix
KDBAPIAQCE -> sixfivetwo
KDBAPIAVLO -> sixfiveone
KDBAJJNRQV -> sixfoursix
KDBAJJNQCE -> sixfourtwo
KDBAJJNVLO -> sixfourone
KDBMBPRBLO -> sixtwonine
KDBMBPZBDO -> sixtwofive
KDBMBPZVEB -> sixtwofour
KDBMBPFFHE -> sixtwozero
KDBRKZRBLO -> sixonenine
KDBRKZZBDO -> sixonefive
KDBRKZZVEB -> sixonefour
KDBRKZFFHE -> sixonezero
KDBGTMQRQV -> sixzerosix
KDBGTMQQCE -> sixzerotwo
KDBGTMQVLO -> sixzeroone
XDDBFVHRQV -> fivesixsix
XDDBFVHQCE -> fivesixtwo
XDDBFVHVLO -> fivesixone
XDDBEHQRQV -> fivetwosix
XDDBEHQQCE -> fivetwotwo
XDDBEHQVLO -> fivetwoone
XDDBJQARQV -> fiveonesix
XDDBJQAQCE -> fiveonetwo
XDDBJQAVLO -> fiveoneone
XXEOFVHRQV -> foursixsix
XXEOFVHQCE -> foursixtwo
XXEOFVHVLO -> foursixone
XXEOEHQRQV -> fourtwosix
XXEOEHQQCE -> fourtwotwo
XXEOEHQVLO -> fourtwoone
XXEOJQARQV -> fouronesix
XXEOJQAQCE -> fouronetwo
XXEOJQAVLO -> fouroneone
JPKSPQARQV -> twoninesix
JPKSPQAQCE -> twoninetwo
JPKSPQAVLO -> twonineone
JPKNPGRBLO -> twosixnine
JPKNPGZBDO -> twosixfive
JPKNPGZVEB -> twosixfour
JPKNPGFFHE -> twosixzero
JPKAPIARQV -> twofivesix
JPKAPIAQCE -> twofivetwo
JPKAPIAVLO -> twofiveone
JPKAJJNRQV -> twofoursix
JPKAJJNQCE -> twofourtwo
JPKAJJNVLO -> twofourone
JPKMBPRBLO -> twotwonine
JPKMBPZBDO -> twotwofive
JPKMBPZVEB -> twotwofour
JPKMBPFFHE -> twotwozero
JPKRKZRBLO -> twoonenine
JPKRKZZBDO -> twoonefive
JPKRKZZVEB -> twoonefour
JPKRKZFFHE -> twoonezero
JPKGTMQRQV -> twozerosix
JPKGTMQQCE -> twozerotwo
JPKGTMQVLO -> twozeroone
OYUSPQARQV -> oneninesix
OYUSPQAQCE -> oneninetwo
OYUSPQAVLO -> onenineone
OYUNPGRBLO -> onesixnine
OYUNPGZBDO -> onesixfive
OYUNPGZVEB -> onesixfour
OYUNPGFFHE -> onesixzero
OYUAPIARQV -> onefivesix
OYUAPIAQCE -> onefivetwo
OYUAPIAVLO -> onefiveone
OYUAJJNRQV -> onefoursix
OYUAJJNQCE -> onefourtwo
OYUAJJNVLO -> onefourone
OYUMBPRBLO -> onetwonine
OYUMBPZBDO -> onetwofive
OYUMBPZVEB -> onetwofour
OYUMBPFFHE -> onetwozero
OYURKZRBLO -> oneonenine
OYURKZZBDO -> oneonefive
OYURKZZVEB -> oneonefour
OYURKZFFHE -> oneonezero
OYUGTMQRQV -> onezerosix
OYUGTMQQCE -> onezerotwo
OYUGTMQVLO -> onezeroone
DHHRFVHRQV -> zerosixsix
DHHRFVHQCE -> zerosixtwo
DHHRFVHVLO -> zerosixone
DHHREHQRQV -> zerotwosix
DHHREHQQCE -> zerotwotwo
DHHREHQVLO -> zerotwoone
DHHRJQARQV -> zeroonesix
DHHRJQAQCE -> zeroonetwo
DHHRJQAVLO -> zerooneone

ZWTIGHOEVVJXP -> ninenineeight
ZWTIGHOEHZUAV -> ninenineseven
ZWTIGHOEGWYAE -> nineninethree
ZWTIPHVBGQHRE -> nineeightnine
ZWTIPHVBGYHJE -> nineeightfive
ZWTIPHVBGYBKR -> nineeightfour
ZWTIPHVBGELNU -> nineeightzero
ZWTIBLGEMQHRE -> ninesevennine
ZWTIBLGEMYHJE -> ninesevenfive
ZWTIBLGEMYBKR -> ninesevenfour
ZWTIBLGEMELNU -> ninesevenzero
ZWTIOHGEVVJXP -> ninefiveeight
ZWTIOHGEHZUAV -> ninefiveseven
ZWTIOHGEGWYAE -> ninefivethree
ZWTIOBHRVVJXP -> ninefoureight
ZWTIOBHRHZUAV -> ninefourseven
ZWTIOBHRGWYAE -> ninefourthree
ZWTIAIKEVQHRE -> ninethreenine
ZWTIAIKEVYHJE -> ninethreefive
ZWTIAIKEVYBKR -> ninethreefour
ZWTIAIKEVELNU -> ninethreezero
ZWTIULKUVVJXP -> ninezeroeight
ZWTIULKUHZUAV -> ninezeroseven
ZWTIULKUGWYAE -> ninezerothree
IWAFACTVVQHRE -> eightninenine
IWAFACTVVYHJE -> eightninefive
IWAFACTVVYBKR -> eightninefour
IWAFACTVVELNU -> eightninezero
IWAFALTCSKXWL -> eighteightsix
IWAFALTCSKWIU -> eighteighttwo
IWAFALTCSKBRE -> eighteightone
IWAFAXXNVQXWL -> eightsevensix
IWAFAXXNVQWIU -> eightseventwo
IWAFAXXNVQBRE -> eightsevenone
IWAFAXTLVVJXP -> eightsixeight
IWAFAXTLHZUAV -> eightsixseven
IWAFAXTLGWYAE -> eightsixthree
IWAFAKTNVQHRE -> eightfivenine
IWAFAKTNVYHJE -> eightfivefive
IWAFAKTNVYBKR -> eightfivefour
IWAFAKTNVELNU -> eightfivezero
IWAFAKNOIQHRE -> eightfournine
IWAFAKNOIYHJE -> eightfourfive
IWAFAKNOIYBKR -> eightfourfour
IWAFAKNOIELNU -> eightfourzero
IWAFAWURVZXWL -> eightthreesix
IWAFAWURVZWIU -> eightthreetwo
IWAFAWURVZBRE -> eightthreeone
IWAFAWFUVVJXP -> eighttwoeight
IWAFAWFUHZUAV -> eighttwoseven
IWAFAWFUGWYAE -> eighttwothree
IWAFABOEVVJXP -> eightoneeight
IWAFABOEHZUAV -> eightoneseven
IWAFABOEGWYAE -> eightonethree
IWAFAQXRLQHRE -> eightzeronine
IWAFAQXRLYHJE -> eightzerofive
IWAFAQXRLYBKR -> eightzerofour
IWAFAQXRLELNU -> eightzerozero
UALIGCTVVQHRE -> sevenninenine
UALIGCTVVYHJE -> sevenninefive
UALIGCTVVYBKR -> sevenninefour
UALIGCTVVELNU -> sevenninezero
UALIGLTCSKXWL -> seveneightsix
UALIGLTCSKWIU -> seveneighttwo
UALIGLTCSKBRE -> seveneightone
UALIGXXNVQXWL -> sevensevensix
UALIGXXNVQWIU -> sevenseventwo
UALIGXXNVQBRE -> sevensevenone
UALIGXTLVVJXP -> sevensixeight
UALIGXTLHZUAV -> sevensixseven
UALIGXTLGWYAE -> sevensixthree
UALIGKTNVQHRE -> sevenfivenine
UALIGKTNVYHJE -> sevenfivefive
UALIGKTNVYBKR -> sevenfivefour
UALIGKTNVELNU -> sevenfivezero
UALIGKNOIQHRE -> sevenfournine
UALIGKNOIYHJE -> sevenfourfive
UALIGKNOIYBKR -> sevenfourfour
UALIGKNOIELNU -> sevenfourzero
UALIGWURVZXWL -> seventhreesix
UALIGWURVZWIU -> seventhreetwo
UALIGWURVZBRE -> seventhreeone
UALIGWFUVVJXP -> seventwoeight
UALIGWFUHZUAV -> seventwoseven
UALIGWFUGWYAE -> seventwothree
UALIGBOEVVJXP -> sevenoneeight
UALIGBOEHZUAV -> sevenoneseven
UALIGBOEGWYAE -> sevenonethree
UALIGQXRLQHRE -> sevenzeronine
UALIGQXRLYHJE -> sevenzerofive
UALIGQXRLYBKR -> sevenzerofour
UALIGQXRLELNU -> sevenzerozero
UWJILJUPVVJXP -> sixeighteight
UWJILJUPHZUAV -> sixeightseven
UWJILJUPGWYAE -> sixeightthree
UWJUPUXVVVJXP -> sixseveneight
UWJUPUXVHZUAV -> sixsevenseven
UWJUPUXVGWYAE -> sixseventhree
UWJTMYXEVVJXP -> sixthreeeight
UWJTMYXEHZUAV -> sixthreeseven
UWJTMYXEGWYAE -> sixthreethree
HWLIGHOEVVJXP -> fivenineeight
HWLIGHOEHZUAV -> fivenineseven
HWLIGHOEGWYAE -> fiveninethree
HWLIPHVBGQHRE -> fiveeightnine
HWLIPHVBGYHJE -> fiveeightfive
HWLIPHVBGYBKR -> fiveeightfour
HWLIPHVBGELNU -> fiveeightzero
HWLIBLGEMQHRE -> fivesevennine
HWLIBLGEMYHJE -> fivesevenfive
HWLIBLGEMYBKR -> fivesevenfour
HWLIBLGEMELNU -> fivesevenzero
HWLIOHGEVVJXP -> fivefiveeight
HWLIOHGEHZUAV -> fivefiveseven
HWLIOHGEGWYAE -> fivefivethree
HWLIOBHRVVJXP -> fivefoureight
HWLIOBHRHZUAV -> fivefourseven
HWLIOBHRGWYAE -> fivefourthree
HWLIAIKEVQHRE -> fivethreenine
HWLIAIKEVYHJE -> fivethreefive
HWLIAIKEVYBKR -> fivethreefour
HWLIAIKEVELNU -> fivethreezero
HWLIULKUVVJXP -> fivezeroeight
HWLIULKUHZUAV -> fivezeroseven
HWLIULKUGWYAE -> fivezerothree
HQMVGHOEVVJXP -> fournineeight
HQMVGHOEHZUAV -> fournineseven
HQMVGHOEGWYAE -> fourninethree
HQMVPHVBGQHRE -> foureightnine
HQMVPHVBGYHJE -> foureightfive
HQMVPHVBGYBKR -> foureightfour
HQMVPHVBGELNU -> foureightzero
HQMVBLGEMQHRE -> foursevennine
HQMVBLGEMYHJE -> foursevenfive
HQMVBLGEMYBKR -> foursevenfour
HQMVBLGEMELNU -> foursevenzero
HQMVOHGEVVJXP -> fourfiveeight
HQMVOHGEHZUAV -> fourfiveseven
HQMVOHGEGWYAE -> fourfivethree
HQMVOBHRVVJXP -> fourfoureight
HQMVOBHRHZUAV -> fourfourseven
HQMVOBHRGWYAE -> fourfourthree
HQMVAIKEVQHRE -> fourthreenine
HQMVAIKEVYHJE -> fourthreefive
HQMVAIKEVYBKR -> fourthreefour
HQMVAIKEVELNU -> fourthreezero
HQMVULKUVVJXP -> fourzeroeight
HQMVULKUHZUAV -> fourzeroseven
HQMVULKUGWYAE -> fourzerothree
TXPIPCTVVQHRE -> threeninenine
TXPIPCTVVYHJE -> threeninefive
TXPIPCTVVYBKR -> threeninefour
TXPIPCTVVELNU -> threeninezero
TXPIPLTCSKXWL -> threeeightsix
TXPIPLTCSKWIU -> threeeighttwo
TXPIPLTCSKBRE -> threeeightone
TXPIPXXNVQXWL -> threesevensix
TXPIPXXNVQWIU -> threeseventwo
TXPIPXXNVQBRE -> threesevenone
TXPIPXTLVVJXP -> threesixeight
TXPIPXTLHZUAV -> threesixseven
TXPIPXTLGWYAE -> threesixthree
TXPIPKTNVQHRE -> threefivenine
TXPIPKTNVYHJE -> threefivefive
TXPIPKTNVYBKR -> threefivefour
TXPIPKTNVELNU -> threefivezero
TXPIPKNOIQHRE -> threefournine
TXPIPKNOIYHJE -> threefourfive
TXPIPKNOIYBKR -> threefourfour
TXPIPKNOIELNU -> threefourzero
TXPIPWURVZXWL -> threethreesix
TXPIPWURVZWIU -> threethreetwo
TXPIPWURVZBRE -> threethreeone
TXPIPWFUVVJXP -> threetwoeight
TXPIPWFUHZUAV -> threetwoseven
TXPIPWFUGWYAE -> threetwothree
TXPIPBOEVVJXP -> threeoneeight
TXPIPBOEHZUAV -> threeoneseven
TXPIPBOEGWYAE -> threeonethree
TXPIPQXRLQHRE -> threezeronine
TXPIPQXRLYHJE -> threezerofive
TXPIPQXRLYBKR -> threezerofour
TXPIPQXRLELNU -> threezerozero
TISILJUPVVJXP -> twoeighteight
TISILJUPHZUAV -> twoeightseven
TISILJUPGWYAE -> twoeightthree
TISUPUXVVVJXP -> twoseveneight
TISUPUXVHZUAV -> twosevenseven
TISUPUXVGWYAE -> twoseventhree
TISTMYXEVVJXP -> twothreeeight
TISTMYXEHZUAV -> twothreeseven
TISTMYXEGWYAE -> twothreethree
YRCILJUPVVJXP -> oneeighteight
YRCILJUPHZUAV -> oneeightseven
YRCILJUPGWYAE -> oneeightthree
YRCUPUXVVVJXP -> oneseveneight
YRCUPUXVHZUAV -> onesevenseven
YRCUPUXVGWYAE -> oneseventhree
YRCTMYXEVVJXP -> onethreeeight
YRCTMYXEHZUAV -> onethreeseven
YRCTMYXEGWYAE -> onethreethree
NAPYGHOEVVJXP -> zeronineeight
NAPYGHOEHZUAV -> zeronineseven
NAPYGHOEGWYAE -> zeroninethree
NAPYPHVBGQHRE -> zeroeightnine
NAPYPHVBGYHJE -> zeroeightfive
NAPYPHVBGYBKR -> zeroeightfour
NAPYPHVBGELNU -> zeroeightzero
NAPYBLGEMQHRE -> zerosevennine
NAPYBLGEMYHJE -> zerosevenfive
NAPYBLGEMYBKR -> zerosevenfour
NAPYBLGEMELNU -> zerosevenzero
NAPYOHGEVVJXP -> zerofiveeight
NAPYOHGEHZUAV -> zerofiveseven
NAPYOHGEGWYAE -> zerofivethree
NAPYOBHRVVJXP -> zerofoureight
NAPYOBHRHZUAV -> zerofourseven
NAPYOBHRGWYAE -> zerofourthree
NAPYAIKEVQHRE -> zerothreenine
NAPYAIKEVYHJE -> zerothreefive
NAPYAIKEVYBKR -> zerothreefour
NAPYAIKEVELNU -> zerothreezero
NAPYULKUVVJXP -> zerozeroeight
NAPYULKUHZUAV -> zerozeroseven
NAPYULKUGWYAE -> zerozerothree

RJPNZWYMYDQGK -> ninenineeight
RJPNZWYMKHBJQ -> ninenineseven
RJPNZWYMJEFJZ -> nineninethree
RJPNIWFJJYOAZ -> nineeightnine
RJPNIWFJJGOSZ -> nineeightfive
RJPNIWFJJGITM -> nineeightfour
RJPNIWFJJMSWP -> nineeightzero
RJPNUAQMPYOAZ -> ninesevennine
RJPNUAQMPGOSZ -> ninesevenfive
RJPNUAQMPGITM -> ninesevenfour
RJPNUAQMPMSWP -> ninesevenzero
RJPNHWQMYDQGK -> ninefiveeight
RJPNHWQMKHBJQ -> ninefiveseven
RJPNHWQMJEFJZ -> ninefivethree
RJPNHQRZYDQGK -> ninefoureight
RJPNHQRZKHBJQ -> ninefourseven
RJPNHQRZJEFJZ -> ninefourthree
RJPNTXUMYYOAZ -> ninethreenine
RJPNTXUMYGOSZ -> ninethreefive
RJPNTXUMYGITM -> ninethreefour
RJPNTXUMYMSWP -> ninethreezero
RJPNNAUCYDQGK -> ninezeroeight
RJPNNAUCKHBJQ -> ninezeroseven
RJPNNAUCJEFJZ -> ninezerothree
AJWKTRDDYYOAZ -> eightninenine
AJWKTRDDYGOSZ -> eightninefive
AJWKTRDDYGITM -> eightninefour
AJWKTRDDYMSWP -> eightninezero
AJWKTADKVSEFG -> eighteightsix
AJWKTADKVSDRP -> eighteighttwo
AJWKTADKVSIAZ -> eighteightone
AJWKTMHVYYEFG -> eightsevensix
AJWKTMHVYYDRP -> eightseventwo
AJWKTMHVYYIAZ -> eightsevenone
AJWKTMDTYDQGK -> eightsixeight
AJWKTMDTKHBJQ -> eightsixseven
AJWKTMDTJEFJZ -> eightsixthree
AJWKTZDVYYOAZ -> eightfivenine
AJWKTZDVYGOSZ -> eightfivefive
AJWKTZDVYGITM -> eightfivefour
AJWKTZDVYMSWP -> eightfivezero
AJWKTZXWLYOAZ -> eightfournine
AJWKTZXWLGOSZ -> eightfourfive
AJWKTZXWLGITM -> eightfourfour
AJWKTZXWLMSWP -> eightfourzero
AJWKTLEZYHEFG -> eightthreesix
AJWKTLEZYHDRP -> eightthreetwo
AJWKTLEZYHIAZ -> eightthreeone
AJWKTLPCYDQGK -> eighttwoeight
AJWKTLPCKHBJQ -> eighttwoseven
AJWKTLPCJEFJZ -> eighttwothree
AJWKTQYMYDQGK -> eightoneeight
AJWKTQYMKHBJQ -> eightoneseven
AJWKTQYMJEFJZ -> eightonethree
AJWKTFHZOYOAZ -> eightzeronine
AJWKTFHZOGOSZ -> eightzerofive
AJWKTFHZOGITM -> eightzerofour
AJWKTFHZOMSWP -> eightzerozero
MNHNZRDDYYOAZ -> sevenninenine
MNHNZRDDYGOSZ -> sevenninefive
MNHNZRDDYGITM -> sevenninefour
MNHNZRDDYMSWP -> sevenninezero
MNHNZADKVSEFG -> seveneightsix
MNHNZADKVSDRP -> seveneighttwo
MNHNZADKVSIAZ -> seveneightone
MNHNZMHVYYEFG -> sevensevensix
MNHNZMHVYYDRP -> sevenseventwo
MNHNZMHVYYIAZ -> sevensevenone
MNHNZMDTYDQGK -> sevensixeight
MNHNZMDTKHBJQ -> sevensixseven
MNHNZMDTJEFJZ -> sevensixthree
MNHNZZDVYYOAZ -> sevenfivenine
MNHNZZDVYGOSZ -> sevenfivefive
MNHNZZDVYGITM -> sevenfivefour
MNHNZZDVYMSWP -> sevenfivezero
MNHNZZXWLYOAZ -> sevenfournine
MNHNZZXWLGOSZ -> sevenfourfive
MNHNZZXWLGITM -> sevenfourfour
MNHNZZXWLMSWP -> sevenfourzero
MNHNZLEZYHEFG -> seventhreesix
MNHNZLEZYHDRP -> seventhreetwo
MNHNZLEZYHIAZ -> seventhreeone
MNHNZLPCYDQGK -> seventwoeight
MNHNZLPCKHBJQ -> seventwoseven
MNHNZLPCJEFJZ -> seventwothree
MNHNZQYMYDQGK -> sevenoneeight
MNHNZQYMKHBJQ -> sevenoneseven
MNHNZQYMJEFJZ -> sevenonethree
MNHNZFHZOYOAZ -> sevenzeronine
MNHNZFHZOGOSZ -> sevenzerofive
MNHNZFHZOGITM -> sevenzerofour
MNHNZFHZOMSWP -> sevenzerozero
MJFNEYEXYDQGK -> sixeighteight
MJFNEYEXKHBJQ -> sixeightseven
MJFNEYEXJEFJZ -> sixeightthree
MJFZIJHDYDQGK -> sixseveneight
MJFZIJHDKHBJQ -> sixsevenseven
MJFZIJHDJEFJZ -> sixseventhree
MJFYFNHMYDQGK -> sixthreeeight
MJFYFNHMKHBJQ -> sixthreeseven
MJFYFNHMJEFJZ -> sixthreethree
ZJHNZWYMYDQGK -> fivenineeight
ZJHNZWYMKHBJQ -> fivenineseven
ZJHNZWYMJEFJZ -> fiveninethree
ZJHNIWFJJYOAZ -> fiveeightnine
ZJHNIWFJJGOSZ -> fiveeightfive
ZJHNIWFJJGITM -> fiveeightfour
ZJHNIWFJJMSWP -> fiveeightzero
ZJHNUAQMPYOAZ -> fivesevennine
ZJHNUAQMPGOSZ -> fivesevenfive
ZJHNUAQMPGITM -> fivesevenfour
ZJHNUAQMPMSWP -> fivesevenzero
ZJHNHWQMYDQGK -> fivefiveeight
ZJHNHWQMKHBJQ -> fivefiveseven
ZJHNHWQMJEFJZ -> fivefivethree
ZJHNHQRZYDQGK -> fivefoureight
ZJHNHQRZKHBJQ -> fivefourseven
ZJHNHQRZJEFJZ -> fivefourthree
ZJHNTXUMYYOAZ -> fivethreenine
ZJHNTXUMYGOSZ -> fivethreefive
ZJHNTXUMYGITM -> fivethreefour
ZJHNTXUMYMSWP -> fivethreezero
ZJHNNAUCYDQGK -> fivezeroeight
ZJHNNAUCKHBJQ -> fivezeroseven
ZJHNNAUCJEFJZ -> fivezerothree
ZDIAZWYMYDQGK -> fournineeight
ZDIAZWYMKHBJQ -> fournineseven
ZDIAZWYMJEFJZ -> fourninethree
ZDIAIWFJJYOAZ -> foureightnine
ZDIAIWFJJGOSZ -> foureightfive
ZDIAIWFJJGITM -> foureightfour
ZDIAIWFJJMSWP -> foureightzero
ZDIAUAQMPYOAZ -> foursevennine
ZDIAUAQMPGOSZ -> foursevenfive
ZDIAUAQMPGITM -> foursevenfour
ZDIAUAQMPMSWP -> foursevenzero
ZDIAHWQMYDQGK -> fourfiveeight
ZDIAHWQMKHBJQ -> fourfiveseven
ZDIAHWQMJEFJZ -> fourfivethree
ZDIAHQRZYDQGK -> fourfoureight
ZDIAHQRZKHBJQ -> fourfourseven
ZDIAHQRZJEFJZ -> fourfourthree
ZDIATXUMYYOAZ -> fourthreenine
ZDIATXUMYGOSZ -> fourthreefive
ZDIATXUMYGITM -> fourthreefour
ZDIATXUMYMSWP -> fourthreezero
ZDIANAUCYDQGK -> fourzeroeight
ZDIANAUCKHBJQ -> fourzeroseven
ZDIANAUCJEFJZ -> fourzerothree
LKLNIRDDYYOAZ -> threeninenine
LKLNIRDDYGOSZ -> threeninefive
LKLNIRDDYGITM -> threeninefour
LKLNIRDDYMSWP -> threeninezero
LKLNIADKVSEFG -> threeeightsix
LKLNIADKVSDRP -> threeeighttwo
LKLNIADKVSIAZ -> threeeightone
LKLNIMHVYYEFG -> threesevensix
LKLNIMHVYYDRP -> threeseventwo
LKLNIMHVYYIAZ -> threesevenone
LKLNIMDTYDQGK -> threesixeight
LKLNIMDTKHBJQ -> threesixseven
LKLNIMDTJEFJZ -> threesixthree
LKLNIZDVYYOAZ -> threefivenine
LKLNIZDVYGOSZ -> threefivefive
LKLNIZDVYGITM -> threefivefour
LKLNIZDVYMSWP -> threefivezero
LKLNIZXWLYOAZ -> threefournine
LKLNIZXWLGOSZ -> threefourfive
LKLNIZXWLGITM -> threefourfour
LKLNIZXWLMSWP -> threefourzero
LKLNILEZYHEFG -> threethreesix
LKLNILEZYHDRP -> threethreetwo
LKLNILEZYHIAZ -> threethreeone
LKLNILPCYDQGK -> threetwoeight
LKLNILPCKHBJQ -> threetwoseven
LKLNILPCJEFJZ -> threetwothree
LKLNIQYMYDQGK -> threeoneeight
LKLNIQYMKHBJQ -> threeoneseven
LKLNIQYMJEFJZ -> threeonethree
LKLNIFHZOYOAZ -> threezeronine
LKLNIFHZOGOSZ -> threezerofive
LKLNIFHZOGITM -> threezerofour
LKLNIFHZOMSWP -> threezerozero
LVONEYEXYDQGK -> twoeighteight
LVONEYEXKHBJQ -> twoeightseven
LVONEYEXJEFJZ -> twoeightthree
LVOZIJHDYDQGK -> twoseveneight
LVOZIJHDKHBJQ -> twosevenseven
LVOZIJHDJEFJZ -> twoseventhree
LVOYFNHMYDQGK -> twothreeeight
LVOYFNHMKHBJQ -> twothreeseven
LVOYFNHMJEFJZ -> twothreethree
QEYNEYEXYDQGK -> oneeighteight
QEYNEYEXKHBJQ -> oneeightseven
QEYNEYEXJEFJZ -> oneeightthree
QEYZIJHDYDQGK -> oneseveneight
QEYZIJHDKHBJQ -> onesevenseven
QEYZIJHDJEFJZ -> oneseventhree
QEYYFNHMYDQGK -> onethreeeight
QEYYFNHMKHBJQ -> onethreeseven
QEYYFNHMJEFJZ -> onethreethree
FNLDZWYMYDQGK -> zeronineeight
FNLDZWYMKHBJQ -> zeronineseven
FNLDZWYMJEFJZ -> zeroninethree
FNLDIWFJJYOAZ -> zeroeightnine
FNLDIWFJJGOSZ -> zeroeightfive
FNLDIWFJJGITM -> zeroeightfour
FNLDIWFJJMSWP -> zeroeightzero
FNLDUAQMPYOAZ -> zerosevennine
FNLDUAQMPGOSZ -> zerosevenfive
FNLDUAQMPGITM -> zerosevenfour
FNLDUAQMPMSWP -> zerosevenzero
FNLDHWQMYDQGK -> zerofiveeight
FNLDHWQMKHBJQ -> zerofiveseven
FNLDHWQMJEFJZ -> zerofivethree
FNLDHQRZYDQGK -> zerofoureight
FNLDHQRZKHBJQ -> zerofourseven
FNLDHQRZJEFJZ -> zerofourthree
FNLDTXUMYYOAZ -> zerothreenine
FNLDTXUMYGOSZ -> zerothreefive
FNLDTXUMYGITM -> zerothreefour
FNLDTXUMYMSWP -> zerothreezero
FNLDNAUCYDQGK -> zerozeroeight
FNLDNAUCKHBJQ -> zerozeroseven
FNLDNAUCJEFJZ -> zerozerothree

AAVQSSCMIRMO -> nineninenine
AAVQSSCMQREO -> nineninefive
AAVQSSCMQLFB -> nineninefour
AAVQSSCMWVIE -> nineninezero
AAVQBSJJCHRV -> nineeightsix
AAVQBSJJCGDE -> nineeighttwo
AAVQBSJJCLMO -> nineeightone
AAVQNWUMIHRV -> ninesevensix
AAVQNWUMIGDE -> nineseventwo
AAVQNWUMILMO -> ninesevenone
AAVQNSSMNTSZ -> ninesixeight
AAVQNSSYREVF -> ninesixseven
AAVQNSSXOIVO -> ninesixthree
AAVQASUMIRMO -> ninefivenine
AAVQASUMQREO -> ninefivefive
AAVQASUMQLFB -> ninefivefour
AAVQASUMWVIE -> ninefivezero
AAVQAMVZIRMO -> ninefournine
AAVQAMVZQREO -> ninefourfive
AAVQAMVZQLFB -> ninefourfour
AAVQAMVZWVIE -> ninefourzero
AAVQMTYMRHRV -> ninethreesix
AAVQMTYMRGDE -> ninethreetwo
AAVQMTYMRLMO -> ninethreeone
AAVQMEBMNTSZ -> ninetwoeight
AAVQMEBYREVF -> ninetwoseven
AAVQMEBXOIVO -> ninetwothree
AAVQRNLMNTSZ -> nineoneeight
AAVQRNLYREVF -> nineoneseven
AAVQRNLXOIVO -> nineonethree
AAVQGWYCIRMO -> ninezeronine
AAVQGWYCQREO -> ninezerofive
AAVQGWYCQLFB -> ninezerofour
AAVQGWYCWVIE -> ninezerozero
JACNMNHDRHRV -> eightninesix
JACNMNHDRGDE -> eightninetwo
JACNMNHDRLMO -> eightnineone
JACNMIHTIRMO -> eightsixnine
JACNMIHTQREO -> eightsixfive
JACNMIHTQLFB -> eightsixfour
JACNMIHTWVIE -> eightsixzero
JACNMVHVRHRV -> eightfivesix
JACNMVHVRGDE -> eightfivetwo
JACNMVHVRLMO -> eightfiveone
JACNMVBWEHRV -> eightfoursix
JACNMVBWEGDE -> eightfourtwo
JACNMVBWELMO -> eightfourone
JACNMHTCIRMO -> eighttwonine
JACNMHTCQREO -> eighttwofive
JACNMHTCQLFB -> eighttwofour
JACNMHTCWVIE -> eighttwozero
JACNMMCMIRMO -> eightonenine
JACNMMCMQREO -> eightonefive
JACNMMCMQLFB -> eightonefour
JACNMMCMWVIE -> eightonezero
JACNMBLZHHRV -> eightzerosix
JACNMBLZHGDE -> eightzerotwo
JACNMBLZHLMO -> eightzeroone
VENQSNHDRHRV -> sevenninesix
VENQSNHDRGDE -> sevenninetwo
VENQSNHDRLMO -> sevennineone
VENQSIHTIRMO -> sevensixnine
VENQSIHTQREO -> sevensixfive
VENQSIHTQLFB -> sevensixfour
VENQSIHTWVIE -> sevensixzero
VENQSVHVRHRV -> sevenfivesix
VENQSVHVRGDE -> sevenfivetwo
VENQSVHVRLMO -> sevenfiveone
VENQSVBWEHRV -> sevenfoursix
VENQSVBWEGDE -> sevenfourtwo
VENQSVBWELMO -> sevenfourone
VENQSHTCIRMO -> seventwonine
VENQSHTCQREO -> seventwofive
VENQSHTCQLFB -> seventwofour
VENQSHTCWVIE -> seventwozero
VENQSMCMIRMO -> sevenonenine
VENQSMCMQREO -> sevenonefive
VENQSMCMQLFB -> sevenonefour
VENQSMCMWVIE -> sevenonezero
VENQSBLZHHRV -> sevenzerosix
VENQSBLZHGDE -> sevenzerotwo
VENQSBLZHLMO -> sevenzeroone
VALHXNLMNTSZ -> sixnineeight
VALHXNLYREVF -> sixnineseven
VALHXNLXOIVO -> sixninethree
VALQXUIXIRMO -> sixeightnine
VALQXUIXQREO -> sixeightfive
VALQXUIXQLFB -> sixeightfour
VALQXUIXWVIE -> sixeightzero
VALCBFLDIRMO -> sixsevennine
VALCBFLDQREO -> sixsevenfive
VALCBFLDQLFB -> sixsevenfour
VALCBFLDWVIE -> sixsevenzero
VALPXFLMNTSZ -> sixfiveeight
VALPXFLYREVF -> sixfiveseven
VALPXFLXOIVO -> sixfivethree
VALPRGYMNTSZ -> sixfoureight
VALPRGYYREVF -> sixfourseven
VALPRGYXOIVO -> sixfourthree
VALBYJLMIRMO -> sixthreenine
VALBYJLMQREO -> sixthreefive
VALBYJLMQLFB -> sixthreefour
VALBYJLMWVIE -> sixthreezero
VALVBJBMNTSZ -> sixzeroeight
VALVBJBYREVF -> sixzeroseven
VALVBJBXOIVO -> sixzerothree
IANQSSCMIRMO -> fiveninenine
IANQSSCMQREO -> fiveninefive
IANQSSCMQLFB -> fiveninefour
IANQSSCMWVIE -> fiveninezero
IANQBSJJCHRV -> fiveeightsix
IANQBSJJCGDE -> fiveeighttwo
IANQBSJJCLMO -> fiveeightone
IANQNWUMIHRV -> fivesevensix
IANQNWUMIGDE -> fiveseventwo
IANQNWUMILMO -> fivesevenone
IANQNSSMNTSZ -> fivesixeight
IANQNSSYREVF -> fivesixseven
IANQNSSXOIVO -> fivesixthree
IANQASUMIRMO -> fivefivenine
IANQASUMQREO -> fivefivefive
IANQASUMQLFB -> fivefivefour
IANQASUMWVIE -> fivefivezero
IANQAMVZIRMO -> fivefournine
IANQAMVZQREO -> fivefourfive
IANQAMVZQLFB -> fivefourfour
IANQAMVZWVIE -> fivefourzero
IANQMTYMRHRV -> fivethreesix
IANQMTYMRGDE -> fivethreetwo
IANQMTYMRLMO -> fivethreeone
IANQMEBMNTSZ -> fivetwoeight
IANQMEBYREVF -> fivetwoseven
IANQMEBXOIVO -> fivetwothree
IANQRNLMNTSZ -> fiveoneeight
IANQRNLYREVF -> fiveoneseven
IANQRNLXOIVO -> fiveonethree
IANQGWYCIRMO -> fivezeronine
IANQGWYCQREO -> fivezerofive
IANQGWYCQLFB -> fivezerofour
IANQGWYCWVIE -> fivezerozero
IUODSSCMIRMO -> fourninenine
IUODSSCMQREO -> fourninefive
IUODSSCMQLFB -> fourninefour
IUODSSCMWVIE -> fourninezero
IUODBSJJCHRV -> foureightsix
IUODBSJJCGDE -> foureighttwo
IUODBSJJCLMO -> foureightone
IUODNWUMIHRV -> foursevensix
IUODNWUMIGDE -> fourseventwo
IUODNWUMILMO -> foursevenone
IUODNSSMNTSZ -> foursixeight
IUODNSSYREVF -> foursixseven
IUODNSSXOIVO -> foursixthree
IUODASUMIRMO -> fourfivenine
IUODASUMQREO -> fourfivefive
IUODASUMQLFB -> fourfivefour
IUODASUMWVIE -> fourfivezero
IUODAMVZIRMO -> fourfournine
IUODAMVZQREO -> fourfourfive
IUODAMVZQLFB -> fourfourfour
IUODAMVZWVIE -> fourfourzero
IUODMTYMRHRV -> fourthreesix
IUODMTYMRGDE -> fourthreetwo
IUODMTYMRLMO -> fourthreeone
IUODMEBMNTSZ -> fourtwoeight
IUODMEBYREVF -> fourtwoseven
IUODMEBXOIVO -> fourtwothree
IUODRNLMNTSZ -> fouroneeight
IUODRNLYREVF -> fouroneseven
IUODRNLXOIVO -> fouronethree
IUODGWYCIRMO -> fourzeronine
IUODGWYCQREO -> fourzerofive
IUODGWYCQLFB -> fourzerofour
IUODGWYCWVIE -> fourzerozero
UBRQBNHDRHRV -> threeninesix
UBRQBNHDRGDE -> threeninetwo
UBRQBNHDRLMO -> threenineone
UBRQBIHTIRMO -> threesixnine
UBRQBIHTQREO -> threesixfive
UBRQBIHTQLFB -> threesixfour
UBRQBIHTWVIE -> threesixzero
UBRQBVHVRHRV -> threefivesix
UBRQBVHVRGDE -> threefivetwo
UBRQBVHVRLMO -> threefiveone
UBRQBVBWEHRV -> threefoursix
UBRQBVBWEGDE -> threefourtwo
UBRQBVBWELMO -> threefourone
UBRQBHTCIRMO -> threetwonine
UBRQBHTCQREO -> threetwofive
UBRQBHTCQLFB -> threetwofour
UBRQBHTCWVIE -> threetwozero
UBRQBMCMIRMO -> threeonenine
UBRQBMCMQREO -> threeonefive
UBRQBMCMQLFB -> threeonefour
UBRQBMCMWVIE -> threeonezero
UBRQBBLZHHRV -> threezerosix
UBRQBBLZHGDE -> threezerotwo
UBRQBBLZHLMO -> threezeroone
UMUHXNLMNTSZ -> twonineeight
UMUHXNLYREVF -> twonineseven
UMUHXNLXOIVO -> twoninethree
UMUQXUIXIRMO -> twoeightnine
UMUQXUIXQREO -> twoeightfive
UMUQXUIXQLFB -> twoeightfour
UMUQXUIXWVIE -> twoeightzero
UMUCBFLDIRMO -> twosevennine
UMUCBFLDQREO -> twosevenfive
UMUCBFLDQLFB -> twosevenfour
UMUCBFLDWVIE -> twosevenzero
UMUPXFLMNTSZ -> twofiveeight
UMUPXFLYREVF -> twofiveseven
UMUPXFLXOIVO -> twofivethree
UMUPRGYMNTSZ -> twofoureight
UMUPRGYYREVF -> twofourseven
UMUPRGYXOIVO -> twofourthree
UMUBYJLMIRMO -> twothreenine
UMUBYJLMQREO -> twothreefive
UMUBYJLMQLFB -> twothreefour
UMUBYJLMWVIE -> twothreezero
UMUVBJBMNTSZ -> twozeroeight
UMUVBJBYREVF -> twozeroseven
UMUVBJBXOIVO -> twozerothree
ZVEHXNLMNTSZ -> onenineeight
ZVEHXNLYREVF -> onenineseven
ZVEHXNLXOIVO -> oneninethree
ZVEQXUIXIRMO -> oneeightnine
ZVEQXUIXQREO -> oneeightfive
ZVEQXUIXQLFB -> oneeightfour
ZVEQXUIXWVIE -> oneeightzero
ZVECBFLDIRMO -> onesevennine
ZVECBFLDQREO -> onesevenfive
ZVECBFLDQLFB -> onesevenfour
ZVECBFLDWVIE -> onesevenzero
ZVEPXFLMNTSZ -> onefiveeight
ZVEPXFLYREVF -> onefiveseven
ZVEPXFLXOIVO -> onefivethree
ZVEPRGYMNTSZ -> onefoureight
ZVEPRGYYREVF -> onefourseven
ZVEPRGYXOIVO -> onefourthree
ZVEBYJLMIRMO -> onethreenine
ZVEBYJLMQREO -> onethreefive
ZVEBYJLMQLFB -> onethreefour
ZVEBYJLMWVIE -> onethreezero
ZVEVBJBMNTSZ -> onezeroeight
ZVEVBJBYREVF -> onezeroseven
ZVEVBJBXOIVO -> onezerothree
OERGSSCMIRMO -> zeroninenine
OERGSSCMQREO -> zeroninefive
OERGSSCMQLFB -> zeroninefour
OERGSSCMWVIE -> zeroninezero
OERGBSJJCHRV -> zeroeightsix
OERGBSJJCGDE -> zeroeighttwo
OERGBSJJCLMO -> zeroeightone
OERGNWUMIHRV -> zerosevensix
OERGNWUMIGDE -> zeroseventwo
OERGNWUMILMO -> zerosevenone
OERGNSSMNTSZ -> zerosixeight
OERGNSSYREVF -> zerosixseven
OERGNSSXOIVO -> zerosixthree
OERGASUMIRMO -> zerofivenine
OERGASUMQREO -> zerofivefive
OERGASUMQLFB -> zerofivefour
OERGASUMWVIE -> zerofivezero
OERGAMVZIRMO -> zerofournine
OERGAMVZQREO -> zerofourfive
OERGAMVZQLFB -> zerofourfour
OERGAMVZWVIE -> zerofourzero
OERGMTYMRHRV -> zerothreesix
OERGMTYMRGDE -> zerothreetwo
OERGMTYMRLMO -> zerothreeone
OERGMEBMNTSZ -> zerotwoeight
OERGMEBYREVF -> zerotwoseven
OERGMEBXOIVO -> zerotwothree
OERGRNLMNTSZ -> zerooneeight
OERGRNLYREVF -> zerooneseven
OERGRNLXOIVO -> zeroonethree
OERGGWYCIRMO -> zerozeronine
OERGGWYCQREO -> zerozerofive
OERGGWYCQLFB -> zerozerofour
OERGGWYCWVIE -> zerozerozero

SKEHLSYYESCLOK -> nineeighteight
SKEHLSYYEEGWRQ -> nineeightseven
SKEHLSYYEDDARZ -> nineeightthree
SKEHXWJBKSCLOK -> nineseveneight
SKEHXWJBKEGWRQ -> ninesevenseven
SKEHXWJBKDDARZ -> nineseventhree
SKEHWTNBTSCLOK -> ninethreeeight
SKEHWTNBTEGWRQ -> ninethreeseven
SKEHWTNBTDDARZ -> ninethreethree
BKLEWNWSTSCLOK -> eightnineeight
BKLEWNWSTEGWRQ -> eightnineseven
BKLEWNWSTDDARZ -> eightninethree
BKLEWWWZQDXJIZ -> eighteightnine
BKLEWWWZQDFJAZ -> eighteightfive
BKLEWWWZQDFDBM -> eighteightfour
BKLEWWWZQDLNEP -> eighteightzero
BKLEWIAKTJXJIZ -> eightsevennine
BKLEWIAKTJFJAZ -> eightsevenfive
BKLEWIAKTJFDBM -> eightsevenfour
BKLEWIAKTJLNEP -> eightsevenzero
BKLEWVWKTSCLOK -> eightfiveeight
BKLEWVWKTEGWRQ -> eightfiveseven
BKLEWVWKTDDARZ -> eightfivethree
BKLEWVQLGSCLOK -> eightfoureight
BKLEWVQLGEGWRQ -> eightfourseven
BKLEWVQLGDDARZ -> eightfourthree
BKLEWHXOTSXJIZ -> eightthreenine
BKLEWHXOTSFJAZ -> eightthreefive
BKLEWHXOTSFDBM -> eightthreefour
BKLEWHXOTSLNEP -> eightthreezero
BKLEWBAOJSCLOK -> eightzeroeight
BKLEWBAOJEGWRQ -> eightzeroseven
BKLEWBAOJDDARZ -> eightzerothree
NOWHCNWSTSCLOK -> sevennineeight
NOWHCNWSTEGWRQ -> sevennineseven
NOWHCNWSTDDARZ -> sevenninethree
NOWHCWWZQDXJIZ -> seveneightnine
NOWHCWWZQDFJAZ -> seveneightfive
NOWHCWWZQDFDBM -> seveneightfour
NOWHCWWZQDLNEP -> seveneightzero
NOWHCIAKTJXJIZ -> sevensevennine
NOWHCIAKTJFJAZ -> sevensevenfive
NOWHCIAKTJFDBM -> sevensevenfour
NOWHCIAKTJLNEP -> sevensevenzero
NOWHCVWKTSCLOK -> sevenfiveeight
NOWHCVWKTEGWRQ -> sevenfiveseven
NOWHCVWKTDDARZ -> sevenfivethree
NOWHCVQLGSCLOK -> sevenfoureight
NOWHCVQLGEGWRQ -> sevenfourseven
NOWHCVQLGDDARZ -> sevenfourthree
NOWHCHXOTSXJIZ -> seventhreenine
NOWHCHXOTSFJAZ -> seventhreefive
NOWHCHXOTSFDBM -> seventhreefour
NOWHCHXOTSLNEP -> seventhreezero
NOWHCBAOJSCLOK -> sevenzeroeight
NOWHCBAOJEGWRQ -> sevenzeroseven
NOWHCBAOJDDARZ -> sevenzerothree
AKWHLSYYESCLOK -> fiveeighteight
AKWHLSYYEEGWRQ -> fiveeightseven
AKWHLSYYEDDARZ -> fiveeightthree
AKWHXWJBKSCLOK -> fiveseveneight
AKWHXWJBKEGWRQ -> fivesevenseven
AKWHXWJBKDDARZ -> fiveseventhree
AKWHWTNBTSCLOK -> fivethreeeight
AKWHWTNBTEGWRQ -> fivethreeseven
AKWHWTNBTDDARZ -> fivethreethree
AEXULSYYESCLOK -> foureighteight
AEXULSYYEEGWRQ -> foureightseven
AEXULSYYEDDARZ -> foureightthree
AEXUXWJBKSCLOK -> fourseveneight
AEXUXWJBKEGWRQ -> foursevenseven
AEXUXWJBKDDARZ -> fourseventhree
AEXUWTNBTSCLOK -> fourthreeeight
AEXUWTNBTEGWRQ -> fourthreeseven
AEXUWTNBTDDARZ -> fourthreethree
MLAHLNWSTSCLOK -> threenineeight
MLAHLNWSTEGWRQ -> threenineseven
MLAHLNWSTDDARZ -> threeninethree
MLAHLWWZQDXJIZ -> threeeightnine
MLAHLWWZQDFJAZ -> threeeightfive
MLAHLWWZQDFDBM -> threeeightfour
MLAHLWWZQDLNEP -> threeeightzero
MLAHLIAKTJXJIZ -> threesevennine
MLAHLIAKTJFJAZ -> threesevenfive
MLAHLIAKTJFDBM -> threesevenfour
MLAHLIAKTJLNEP -> threesevenzero
MLAHLVWKTSCLOK -> threefiveeight
MLAHLVWKTEGWRQ -> threefiveseven
MLAHLVWKTDDARZ -> threefivethree
MLAHLVQLGSCLOK -> threefoureight
MLAHLVQLGEGWRQ -> threefourseven
MLAHLVQLGDDARZ -> threefourthree
MLAHLHXOTSXJIZ -> threethreenine
MLAHLHXOTSFJAZ -> threethreefive
MLAHLHXOTSFDBM -> threethreefour
MLAHLHXOTSLNEP -> threethreezero
MLAHLBAOJSCLOK -> threezeroeight
MLAHLBAOJEGWRQ -> threezeroseven
MLAHLBAOJDDARZ -> threezerothree
GOAXLSYYESCLOK -> zeroeighteight
GOAXLSYYEEGWRQ -> zeroeightseven
GOAXLSYYEDDARZ -> zeroeightthree
GOAXXWJBKSCLOK -> zeroseveneight
GOAXXWJBKEGWRQ -> zerosevenseven
GOAXXWJBKDDARZ -> zeroseventhree
GOAXWTNBTSCLOK -> zerothreeeight
GOAXWTNBTEGWRQ -> zerothreeseven
GOAXWTNBTDDARZ -> zerothreethree

PXQFBMHSOHK -> nineninesix
PXQFBMHSNTT -> nineninetwo
PXQFBMHSSCD -> ninenineone
PXQFWMXJYCD -> ninesixnine
PXQFWMXRYUD -> ninesixfive
PXQFWMXRSVQ -> ninesixfour
PXQFWMXXCYT -> ninesixzero
PXQFJMZSOHK -> ninefivesix
PXQFJMZSNTT -> ninefivetwo
PXQFJMZSSCD -> ninefiveone
PXQFJGAFOHK -> ninefoursix
PXQFJGAFNTT -> ninefourtwo
PXQFJGAFSCD -> ninefourone
PXQFVYGJYCD -> ninetwonine
PXQFVYGRYUD -> ninetwofive
PXQFVYGRSVQ -> ninetwofour
PXQFVYGXCYT -> ninetwozero
PXQFAHQJYCD -> nineonenine
PXQFAHQRYUD -> nineonefive
PXQFAHQRSVQ -> nineonefour
PXQFAHQXCYT -> nineonezero
PXQFPQDIOHK -> ninezerosix
PXQFPQDINTT -> ninezerotwo
PXQFPQDISCD -> ninezeroone
YXXCVCMZOHK -> eightsixsix
YXXCVCMZNTT -> eightsixtwo
YXXCVCMZSCD -> eightsixone
YXXCVBYIOHK -> eighttwosix
YXXCVBYINTT -> eighttwotwo
YXXCVBYISCD -> eighttwoone
YXXCVGHSOHK -> eightonesix
YXXCVGHSNTT -> eightonetwo
YXXCVGHSSCD -> eightoneone
KBIFBCMZOHK -> sevensixsix
KBIFBCMZNTT -> sevensixtwo
KBIFBCMZSCD -> sevensixone
KBIFBBYIOHK -> seventwosix
KBIFBBYINTT -> seventwotwo
KBIFBBYISCD -> seventwoone
KBIFBGHSOHK -> sevenonesix
KBIFBGHSNTT -> sevenonetwo
KBIFBGHSSCD -> sevenoneone
KXGWGHQJYCD -> sixninenine
KXGWGHQRYUD -> sixninefive
KXGWGHQRSVQ -> sixninefour
KXGWGHQXCYT -> sixninezero
KXGFGONDOHK -> sixeightsix
KXGFGONDNTT -> sixeighttwo
KXGFGONDSCD -> sixeightone
KXGRKZQJOHK -> sixsevensix
KXGRKZQJNTT -> sixseventwo
KXGRKZQJSCD -> sixsevenone
KXGRGXQOAIO -> sixsixeight
KXGRGXCSLLU -> sixsixseven
KXGRGXBPPLD -> sixsixthree
KXGEGZQJYCD -> sixfivenine
KXGEGZQRYUD -> sixfivefive
KXGEGZQRSVQ -> sixfivefour
KXGEGZQXCYT -> sixfivezero
KXGEAADJYCD -> sixfournine
KXGEAADRYUD -> sixfourfive
KXGEAADRSVQ -> sixfourfour
KXGEAADXCYT -> sixfourzero
KXGQHDQSOHK -> sixthreesix
KXGQHDQSNTT -> sixthreetwo
KXGQHDQSSCD -> sixthreeone
KXGQSGQOAIO -> sixtwoeight
KXGQSGCSLLU -> sixtwoseven
KXGQSGBPPLD -> sixtwothree
KXGVBQQOAIO -> sixoneeight
KXGVBQCSLLU -> sixoneseven
KXGVBQBPPLD -> sixonethree
KXGKKDGJYCD -> sixzeronine
KXGKKDGRYUD -> sixzerofive
KXGKKDGRSVQ -> sixzerofour
KXGKKDGXCYT -> sixzerozero
XXIFBMHSOHK -> fiveninesix
XXIFBMHSNTT -> fiveninetwo
XXIFBMHSSCD -> fivenineone
XXIFWMXJYCD -> fivesixnine
XXIFWMXRYUD -> fivesixfive
XXIFWMXRSVQ -> fivesixfour
XXIFWMXXCYT -> fivesixzero
XXIFJMZSOHK -> fivefivesix
XXIFJMZSNTT -> fivefivetwo
XXIFJMZSSCD -> fivefiveone
XXIFJGAFOHK -> fivefoursix
XXIFJGAFNTT -> fivefourtwo
XXIFJGAFSCD -> fivefourone
XXIFVYGJYCD -> fivetwonine
XXIFVYGRYUD -> fivetwofive
XXIFVYGRSVQ -> fivetwofour
XXIFVYGXCYT -> fivetwozero
XXIFAHQJYCD -> fiveonenine
XXIFAHQRYUD -> fiveonefive
XXIFAHQRSVQ -> fiveonefour
XXIFAHQXCYT -> fiveonezero
XXIFPQDIOHK -> fivezerosix
XXIFPQDINTT -> fivezerotwo
XXIFPQDISCD -> fivezeroone
XRJSBMHSOHK -> fourninesix
XRJSBMHSNTT -> fourninetwo
XRJSBMHSSCD -> fournineone
XRJSWMXJYCD -> foursixnine
XRJSWMXRYUD -> foursixfive
XRJSWMXRSVQ -> foursixfour
XRJSWMXXCYT -> foursixzero
XRJSJMZSOHK -> fourfivesix
XRJSJMZSNTT -> fourfivetwo
XRJSJMZSSCD -> fourfiveone
XRJSJGAFOHK -> fourfoursix
XRJSJGAFNTT -> fourfourtwo
XRJSJGAFSCD -> fourfourone
XRJSVYGJYCD -> fourtwonine
XRJSVYGRYUD -> fourtwofive
XRJSVYGRSVQ -> fourtwofour
XRJSVYGXCYT -> fourtwozero
XRJSAHQJYCD -> fouronenine
XRJSAHQRYUD -> fouronefive
XRJSAHQRSVQ -> fouronefour
XRJSAHQXCYT -> fouronezero
XRJSPQDIOHK -> fourzerosix
XRJSPQDINTT -> fourzerotwo
XRJSPQDISCD -> fourzeroone
JYMFKCMZOHK -> threesixsix
JYMFKCMZNTT -> threesixtwo
JYMFKCMZSCD -> threesixone
JYMFKBYIOHK -> threetwosix
JYMFKBYINTT -> threetwotwo
JYMFKBYISCD -> threetwoone
JYMFKGHSOHK -> threeonesix
JYMFKGHSNTT -> threeonetwo
JYMFKGHSSCD -> threeoneone
JJPWGHQJYCD -> twoninenine
JJPWGHQRYUD -> twoninefive
JJPWGHQRSVQ -> twoninefour
JJPWGHQXCYT -> twoninezero
JJPFGONDOHK -> twoeightsix
JJPFGONDNTT -> twoeighttwo
JJPFGONDSCD -> twoeightone
JJPRKZQJOHK -> twosevensix
JJPRKZQJNTT -> twoseventwo
JJPRKZQJSCD -> twosevenone
JJPRGXQOAIO -> twosixeight
JJPRGXCSLLU -> twosixseven
JJPRGXBPPLD -> twosixthree
JJPEGZQJYCD -> twofivenine
JJPEGZQRYUD -> twofivefive
JJPEGZQRSVQ -> twofivefour
JJPEGZQXCYT -> twofivezero
JJPEAADJYCD -> twofournine
JJPEAADRYUD -> twofourfive
JJPEAADRSVQ -> twofourfour
JJPEAADXCYT -> twofourzero
JJPQHDQSOHK -> twothreesix
JJPQHDQSNTT -> twothreetwo
JJPQHDQSSCD -> twothreeone
JJPQSGQOAIO -> twotwoeight
JJPQSGCSLLU -> twotwoseven
JJPQSGBPPLD -> twotwothree
JJPVBQQOAIO -> twooneeight
JJPVBQCSLLU -> twooneseven
JJPVBQBPPLD -> twoonethree
JJPKKDGJYCD -> twozeronine
JJPKKDGRYUD -> twozerofive
JJPKKDGRSVQ -> twozerofour
JJPKKDGXCYT -> twozerozero
OSZWGHQJYCD -> oneninenine
OSZWGHQRYUD -> oneninefive
OSZWGHQRSVQ -> oneninefour
OSZWGHQXCYT -> oneninezero
OSZFGONDOHK -> oneeightsix
OSZFGONDNTT -> oneeighttwo
OSZFGONDSCD -> oneeightone
OSZRKZQJOHK -> onesevensix
OSZRKZQJNTT -> oneseventwo
OSZRKZQJSCD -> onesevenone
OSZRGXQOAIO -> onesixeight
OSZRGXCSLLU -> onesixseven
OSZRGXBPPLD -> onesixthree
OSZEGZQJYCD -> onefivenine
OSZEGZQRYUD -> onefivefive
OSZEGZQRSVQ -> onefivefour
OSZEGZQXCYT -> onefivezero
OSZEAADJYCD -> onefournine
OSZEAADRYUD -> onefourfive
OSZEAADRSVQ -> onefourfour
OSZEAADXCYT -> onefourzero
OSZQHDQSOHK -> onethreesix
OSZQHDQSNTT -> onethreetwo
OSZQHDQSSCD -> onethreeone
OSZQSGQOAIO -> onetwoeight
OSZQSGCSLLU -> onetwoseven
OSZQSGBPPLD -> onetwothree
OSZVBQQOAIO -> oneoneeight
OSZVBQCSLLU -> oneoneseven
OSZVBQBPPLD -> oneonethree
OSZKKDGJYCD -> onezeronine
OSZKKDGRYUD -> onezerofive
OSZKKDGRSVQ -> onezerofour
OSZKKDGXCYT -> onezerozero
DBMVBMHSOHK -> zeroninesix
DBMVBMHSNTT -> zeroninetwo
DBMVBMHSSCD -> zeronineone
DBMVWMXJYCD -> zerosixnine
DBMVWMXRYUD -> zerosixfive
DBMVWMXRSVQ -> zerosixfour
DBMVWMXXCYT -> zerosixzero
DBMVJMZSOHK -> zerofivesix
DBMVJMZSNTT -> zerofivetwo
DBMVJMZSSCD -> zerofiveone
DBMVJGAFOHK -> zerofoursix
DBMVJGAFNTT -> zerofourtwo
DBMVJGAFSCD -> zerofourone
DBMVVYGJYCD -> zerotwonine
DBMVVYGRYUD -> zerotwofive
DBMVVYGRSVQ -> zerotwofour
DBMVVYGXCYT -> zerotwozero
DBMVAHQJYCD -> zeroonenine
DBMVAHQRYUD -> zeroonefive
DBMVAHQRSVQ -> zeroonefour
DBMVAHQXCYT -> zeroonezero
DBMVPQDIOHK -> zerozerosix
DBMVPQDINTT -> zerozerotwo
DBMVPQDISCD -> zerozeroone

LWLHCHJRCZQVIH -> nineeighteight
LWLHCHJRCLUGLN -> nineeightseven
LWLHCHJRCKRKLW -> nineeightthree
LWLHOLUUIZQVIH -> nineseveneight
LWLHOLUUILUGLN -> ninesevenseven
LWLHOLUUIKRKLW -> nineseventhree
LWLHNIYURZQVIH -> ninethreeeight
LWLHNIYURLUGLN -> ninethreeseven
LWLHNIYURKRKLW -> ninethreethree
UWSENCHLRZQVIH -> eightnineeight
UWSENCHLRLUGLN -> eightnineseven
UWSENCHLRKRKLW -> eightninethree
UWSENLHSOKLTCW -> eighteightnine
UWSENLHSOKTTUW -> eighteightfive
UWSENLHSOKTNVJ -> eighteightfour
UWSENLHSOKZXYM -> eighteightzero
UWSENXLDRQLTCW -> eightsevennine
UWSENXLDRQTTUW -> eightsevenfive
UWSENXLDRQTNVJ -> eightsevenfour
UWSENXLDRQZXYM -> eightsevenzero
UWSENKHDRZQVIH -> eightfiveeight
UWSENKHDRLUGLN -> eightfiveseven
UWSENKHDRKRKLW -> eightfivethree
UWSENKBEEZQVIH -> eightfoureight
UWSENKBEELUGLN -> eightfourseven
UWSENKBEEKRKLW -> eightfourthree
UWSENWIHRZLTCW -> eightthreenine
UWSENWIHRZTTUW -> eightthreefive
UWSENWIHRZTNVJ -> eightthreefour
UWSENWIHRZZXYM -> eightthreezero
UWSENQLHHZQVIH -> eightzeroeight
UWSENQLHHLUGLN -> eightzeroseven
UWSENQLHHKRKLW -> eightzerothree
GADHTCHLRZQVIH -> sevennineeight
GADHTCHLRLUGLN -> sevennineseven
GADHTCHLRKRKLW -> sevenninethree
GADHTLHSOKLTCW -> seveneightnine
GADHTLHSOKTTUW -> seveneightfive
GADHTLHSOKTNVJ -> seveneightfour
GADHTLHSOKZXYM -> seveneightzero
GADHTXLDRQLTCW -> sevensevennine
GADHTXLDRQTTUW -> sevensevenfive
GADHTXLDRQTNVJ -> sevensevenfour
GADHTXLDRQZXYM -> sevensevenzero
GADHTKHDRZQVIH -> sevenfiveeight
GADHTKHDRLUGLN -> sevenfiveseven
GADHTKHDRKRKLW -> sevenfivethree
GADHTKBEEZQVIH -> sevenfoureight
GADHTKBEELUGLN -> sevenfourseven
GADHTKBEEKRKLW -> sevenfourthree
GADHTWIHRZLTCW -> seventhreenine
GADHTWIHRZTTUW -> seventhreefive
GADHTWIHRZTNVJ -> seventhreefour
GADHTWIHRZZXYM -> seventhreezero
GADHTQLHHZQVIH -> sevenzeroeight
GADHTQLHHLUGLN -> sevenzeroseven
GADHTQLHHKRKLW -> sevenzerothree
TWDHCHJRCZQVIH -> fiveeighteight
TWDHCHJRCLUGLN -> fiveeightseven
TWDHCHJRCKRKLW -> fiveeightthree
TWDHOLUUIZQVIH -> fiveseveneight
TWDHOLUUILUGLN -> fivesevenseven
TWDHOLUUIKRKLW -> fiveseventhree
TWDHNIYURZQVIH -> fivethreeeight
TWDHNIYURLUGLN -> fivethreeseven
TWDHNIYURKRKLW -> fivethreethree
TQEUCHJRCZQVIH -> foureighteight
TQEUCHJRCLUGLN -> foureightseven
TQEUCHJRCKRKLW -> foureightthree
TQEUOLUUIZQVIH -> fourseveneight
TQEUOLUUILUGLN -> foursevenseven
TQEUOLUUIKRKLW -> fourseventhree
TQEUNIYURZQVIH -> fourthreeeight
TQEUNIYURLUGLN -> fourthreeseven
TQEUNIYURKRKLW -> fourthreethree
FXHHCCHLRZQVIH -> threenineeight
FXHHCCHLRLUGLN -> threenineseven
FXHHCCHLRKRKLW -> threeninethree
FXHHCLHSOKLTCW -> threeeightnine
FXHHCLHSOKTTUW -> threeeightfive
FXHHCLHSOKTNVJ -> threeeightfour
FXHHCLHSOKZXYM -> threeeightzero
FXHHCXLDRQLTCW -> threesevennine
FXHHCXLDRQTTUW -> threesevenfive
FXHHCXLDRQTNVJ -> threesevenfour
FXHHCXLDRQZXYM -> threesevenzero
FXHHCKHDRZQVIH -> threefiveeight
FXHHCKHDRLUGLN -> threefiveseven
FXHHCKHDRKRKLW -> threefivethree
FXHHCKBEEZQVIH -> threefoureight
FXHHCKBEELUGLN -> threefourseven
FXHHCKBEEKRKLW -> threefourthree
FXHHCWIHRZLTCW -> threethreenine
FXHHCWIHRZTTUW -> threethreefive
FXHHCWIHRZTNVJ -> threethreefour
FXHHCWIHRZZXYM -> threethreezero
FXHHCQLHHZQVIH -> threezeroeight
FXHHCQLHHLUGLN -> threezeroseven
FXHHCQLHHKRKLW -> threezerothree
ZAHXCHJRCZQVIH -> zeroeighteight
ZAHXCHJRCLUGLN -> zeroeightseven
ZAHXCHJRCKRKLW -> zeroeightthree
ZAHXOLUUIZQVIH -> zeroseveneight
ZAHXOLUUILUGLN -> zerosevenseven
ZAHXOLUUIKRKLW -> zeroseventhree
ZAHXNIYURZQVIH -> zerothreeeight
ZAHXNIYURLUGLN -> zerothreeseven
ZAHXNIYURKRKLW -> zerothreethree

MVSKVZUPDSXAH -> ninenineeight
MVSKVZUPPWIDN -> ninenineseven
MVSKVZUPOTMDW -> nineninethree
MVSKEZBMONVUW -> nineeightnine
MVSKEZBMOVVMW -> nineeightfive
MVSKEZBMOVPNJ -> nineeightfour
MVSKEZBMOBZQM -> nineeightzero
MVSKQDMPUNVUW -> ninesevennine
MVSKQDMPUVVMW -> ninesevenfive
MVSKQDMPUVPNJ -> ninesevenfour
MVSKQDMPUBZQM -> ninesevenzero
MVSKDZMPDSXAH -> ninefiveeight
MVSKDZMPPWIDN -> ninefiveseven
MVSKDZMPOTMDW -> ninefivethree
MVSKDTNCDSXAH -> ninefoureight
MVSKDTNCPWIDN -> ninefourseven
MVSKDTNCOTMDW -> ninefourthree
MVSKPAQPDNVUW -> ninethreenine
MVSKPAQPDVVMW -> ninethreefive
MVSKPAQPDVPNJ -> ninethreefour
MVSKPAQPDBZQM -> ninethreezero
MVSKJDQFDSXAH -> ninezeroeight
MVSKJDQFPWIDN -> ninezeroseven
MVSKJDQFOTMDW -> ninezerothree
VVZHPUZGDNVUW -> eightninenine
VVZHPUZGDVVMW -> eightninefive
VVZHPUZGDVPNJ -> eightninefour
VVZHPUZGDBZQM -> eightninezero
VVZHPDZNAHLZD -> eighteightsix
VVZHPDZNAHKLM -> eighteighttwo
VVZHPDZNAHPUW -> eighteightone
VVZHPPDYDNLZD -> eightsevensix
VVZHPPDYDNKLM -> eightseventwo
VVZHPPDYDNPUW -> eightsevenone
VVZHPPZWDSXAH -> eightsixeight
VVZHPPZWPWIDN -> eightsixseven
VVZHPPZWOTMDW -> eightsixthree
VVZHPCZYDNVUW -> eightfivenine
VVZHPCZYDVVMW -> eightfivefive
VVZHPCZYDVPNJ -> eightfivefour
VVZHPCZYDBZQM -> eightfivezero
VVZHPCTZQNVUW -> eightfournine
VVZHPCTZQVVMW -> eightfourfive
VVZHPCTZQVPNJ -> eightfourfour
VVZHPCTZQBZQM -> eightfourzero
VVZHPOACDWLZD -> eightthreesix
VVZHPOACDWKLM -> eightthreetwo
VVZHPOACDWPUW -> eightthreeone
VVZHPOLFDSXAH -> eighttwoeight
VVZHPOLFPWIDN -> eighttwoseven
VVZHPOLFOTMDW -> eighttwothree
VVZHPTUPDSXAH -> eightoneeight
VVZHPTUPPWIDN -> eightoneseven
VVZHPTUPOTMDW -> eightonethree
VVZHPIDCTNVUW -> eightzeronine
VVZHPIDCTVVMW -> eightzerofive
VVZHPIDCTVPNJ -> eightzerofour
VVZHPIDCTBZQM -> eightzerozero
HZKKVUZGDNVUW -> sevenninenine
HZKKVUZGDVVMW -> sevenninefive
HZKKVUZGDVPNJ -> sevenninefour
HZKKVUZGDBZQM -> sevenninezero
HZKKVDZNAHLZD -> seveneightsix
HZKKVDZNAHKLM -> seveneighttwo
HZKKVDZNAHPUW -> seveneightone
HZKKVPDYDNLZD -> sevensevensix
HZKKVPDYDNKLM -> sevenseventwo
HZKKVPDYDNPUW -> sevensevenone
HZKKVPZWDSXAH -> sevensixeight
HZKKVPZWPWIDN -> sevensixseven
HZKKVPZWOTMDW -> sevensixthree
HZKKVCZYDNVUW -> sevenfivenine
HZKKVCZYDVVMW -> sevenfivefive
HZKKVCZYDVPNJ -> sevenfivefour
HZKKVCZYDBZQM -> sevenfivezero
HZKKVCTZQNVUW -> sevenfournine
HZKKVCTZQVVMW -> sevenfourfive
HZKKVCTZQVPNJ -> sevenfourfour
HZKKVCTZQBZQM -> sevenfourzero
HZKKVOACDWLZD -> seventhreesix
HZKKVOACDWKLM -> seventhreetwo
HZKKVOACDWPUW -> seventhreeone
HZKKVOLFDSXAH -> seventwoeight
HZKKVOLFPWIDN -> seventwoseven
HZKKVOLFOTMDW -> seventwothree
HZKKVTUPDSXAH -> sevenoneeight
HZKKVTUPPWIDN -> sevenoneseven
HZKKVTUPOTMDW -> sevenonethree
HZKKVIDCTNVUW -> sevenzeronine
HZKKVIDCTVVMW -> sevenzerofive
HZKKVIDCTVPNJ -> sevenzerofour
HZKKVIDCTBZQM -> sevenzerozero
HVIKABAADSXAH -> sixeighteight
HVIKABAAPWIDN -> sixeightseven
HVIKABAAOTMDW -> sixeightthree
HVIWEMDGDSXAH -> sixseveneight
HVIWEMDGPWIDN -> sixsevenseven
HVIWEMDGOTMDW -> sixseventhree
HVIVBQDPDSXAH -> sixthreeeight
HVIVBQDPPWIDN -> sixthreeseven
HVIVBQDPOTMDW -> sixthreethree
UVKKVZUPDSXAH -> fivenineeight
UVKKVZUPPWIDN -> fivenineseven
UVKKVZUPOTMDW -> fiveninethree
UVKKEZBMONVUW -> fiveeightnine
UVKKEZBMOVVMW -> fiveeightfive
UVKKEZBMOVPNJ -> fiveeightfour
UVKKEZBMOBZQM -> fiveeightzero
UVKKQDMPUNVUW -> fivesevennine
UVKKQDMPUVVMW -> fivesevenfive
UVKKQDMPUVPNJ -> fivesevenfour
UVKKQDMPUBZQM -> fivesevenzero
UVKKDZMPDSXAH -> fivefiveeight
UVKKDZMPPWIDN -> fivefiveseven
UVKKDZMPOTMDW -> fivefivethree
UVKKDTNCDSXAH -> fivefoureight
UVKKDTNCPWIDN -> fivefourseven
UVKKDTNCOTMDW -> fivefourthree
UVKKPAQPDNVUW -> fivethreenine
UVKKPAQPDVVMW -> fivethreefive
UVKKPAQPDVPNJ -> fivethreefour
UVKKPAQPDBZQM -> fivethreezero
UVKKJDQFDSXAH -> fivezeroeight
UVKKJDQFPWIDN -> fivezeroseven
UVKKJDQFOTMDW -> fivezerothree
UPLXVZUPDSXAH -> fournineeight
UPLXVZUPPWIDN -> fournineseven
UPLXVZUPOTMDW -> fourninethree
UPLXEZBMONVUW -> foureightnine
UPLXEZBMOVVMW -> foureightfive
UPLXEZBMOVPNJ -> foureightfour
UPLXEZBMOBZQM -> foureightzero
UPLXQDMPUNVUW -> foursevennine
UPLXQDMPUVVMW -> foursevenfive
UPLXQDMPUVPNJ -> foursevenfour
UPLXQDMPUBZQM -> foursevenzero
UPLXDZMPDSXAH -> fourfiveeight
UPLXDZMPPWIDN -> fourfiveseven
UPLXDZMPOTMDW -> fourfivethree
UPLXDTNCDSXAH -> fourfoureight
UPLXDTNCPWIDN -> fourfourseven
UPLXDTNCOTMDW -> fourfourthree
UPLXPAQPDNVUW -> fourthreenine
UPLXPAQPDVVMW -> fourthreefive
UPLXPAQPDVPNJ -> fourthreefour
UPLXPAQPDBZQM -> fourthreezero
UPLXJDQFDSXAH -> fourzeroeight
UPLXJDQFPWIDN -> fourzeroseven
UPLXJDQFOTMDW -> fourzerothree
GWOKEUZGDNVUW -> threeninenine
GWOKEUZGDVVMW -> threeninefive
GWOKEUZGDVPNJ -> threeninefour
GWOKEUZGDBZQM -> threeninezero
GWOKEDZNAHLZD -> threeeightsix
GWOKEDZNAHKLM -> threeeighttwo
GWOKEDZNAHPUW -> threeeightone
GWOKEPDYDNLZD -> threesevensix
GWOKEPDYDNKLM -> threeseventwo
GWOKEPDYDNPUW -> threesevenone
GWOKEPZWDSXAH -> threesixeight
GWOKEPZWPWIDN -> threesixseven
GWOKEPZWOTMDW -> threesixthree
GWOKECZYDNVUW -> threefivenine
GWOKECZYDVVMW -> threefivefive
GWOKECZYDVPNJ -> threefivefour
GWOKECZYDBZQM -> threefivezero
GWOKECTZQNVUW -> threefournine
GWOKECTZQVVMW -> threefourfive
GWOKECTZQVPNJ -> threefourfour
GWOKECTZQBZQM -> threefourzero
GWOKEOACDWLZD -> threethreesix
GWOKEOACDWKLM -> threethreetwo
GWOKEOACDWPUW -> threethreeone
GWOKEOLFDSXAH -> threetwoeight
GWOKEOLFPWIDN -> threetwoseven
GWOKEOLFOTMDW -> threetwothree
GWOKETUPDSXAH -> threeoneeight
GWOKETUPPWIDN -> threeoneseven
GWOKETUPOTMDW -> threeonethree
GWOKEIDCTNVUW -> threezeronine
GWOKEIDCTVVMW -> threezerofive
GWOKEIDCTVPNJ -> threezerofour
GWOKEIDCTBZQM -> threezerozero
GHRKABAADSXAH -> twoeighteight
GHRKABAAPWIDN -> twoeightseven
GHRKABAAOTMDW -> twoeightthree
GHRWEMDGDSXAH -> twoseveneight
GHRWEMDGPWIDN -> twosevenseven
GHRWEMDGOTMDW -> twoseventhree
GHRVBQDPDSXAH -> twothreeeight
GHRVBQDPPWIDN -> twothreeseven
GHRVBQDPOTMDW -> twothreethree
LQBKABAADSXAH -> oneeighteight
LQBKABAAPWIDN -> oneeightseven
LQBKABAAOTMDW -> oneeightthree
LQBWEMDGDSXAH -> oneseveneight
LQBWEMDGPWIDN -> onesevenseven
LQBWEMDGOTMDW -> oneseventhree
LQBVBQDPDSXAH -> onethreeeight
LQBVBQDPPWIDN -> onethreeseven
LQBVBQDPOTMDW -> onethreethree
AZOAVZUPDSXAH -> zeronineeight
AZOAVZUPPWIDN -> zeronineseven
AZOAVZUPOTMDW -> zeroninethree
AZOAEZBMONVUW -> zeroeightnine
AZOAEZBMOVVMW -> zeroeightfive
AZOAEZBMOVPNJ -> zeroeightfour
AZOAEZBMOBZQM -> zeroeightzero
AZOAQDMPUNVUW -> zerosevennine
AZOAQDMPUVVMW -> zerosevenfive
AZOAQDMPUVPNJ -> zerosevenfour
AZOAQDMPUBZQM -> zerosevenzero
AZOADZMPDSXAH -> zerofiveeight
AZOADZMPPWIDN -> zerofiveseven
AZOADZMPOTMDW -> zerofivethree
AZOADTNCDSXAH -> zerofoureight
AZOADTNCPWIDN -> zerofourseven
AZOADTNCOTMDW -> zerofourthree
AZOAPAQPDNVUW -> zerothreenine
AZOAPAQPDVVMW -> zerothreefive
AZOAPAQPDVPNJ -> zerothreefour
AZOAPAQPDBZQM -> zerothreezero
AZOAJDQFDSXAH -> zerozeroeight
AZOAJDQFPWIDN -> zerozeroseven
AZOAJDQFOTMDW -> zerozerothree

CRHSHRMALFJXNQ -> nineeighteight
CRHSHRMALRNIQW -> nineeightseven
CRHSHRMALQKMQF -> nineeightthree
CRHSTVXDRFJXNQ -> nineseveneight
CRHSTVXDRRNIQW -> ninesevenseven
CRHSTVXDRQKMQF -> nineseventhree
CRHSSSBDAFJXNQ -> ninethreeeight
CRHSSSBDARNIQW -> ninethreeseven
CRHSSSBDAQKMQF -> ninethreethree
LROPSMKUAFJXNQ -> eightnineeight
LROPSMKUARNIQW -> eightnineseven
LROPSMKUAQKMQF -> eightninethree
LROPSVKBXQEVHF -> eighteightnine
LROPSVKBXQMVZF -> eighteightfive
LROPSVKBXQMPAS -> eighteightfour
LROPSVKBXQSZDV -> eighteightzero
LROPSHOMAWEVHF -> eightsevennine
LROPSHOMAWMVZF -> eightsevenfive
LROPSHOMAWMPAS -> eightsevenfour
LROPSHOMAWSZDV -> eightsevenzero
LROPSUKMAFJXNQ -> eightfiveeight
LROPSUKMARNIQW -> eightfiveseven
LROPSUKMAQKMQF -> eightfivethree
LROPSUENNFJXNQ -> eightfoureight
LROPSUENNRNIQW -> eightfourseven
LROPSUENNQKMQF -> eightfourthree
LROPSGLQAFEVHF -> eightthreenine
LROPSGLQAFMVZF -> eightthreefive
LROPSGLQAFMPAS -> eightthreefour
LROPSGLQAFSZDV -> eightthreezero
LROPSAOQQFJXNQ -> eightzeroeight
LROPSAOQQRNIQW -> eightzeroseven
LROPSAOQQQKMQF -> eightzerothree
XVZSYMKUAFJXNQ -> sevennineeight
XVZSYMKUARNIQW -> sevennineseven
XVZSYMKUAQKMQF -> sevenninethree
XVZSYVKBXQEVHF -> seveneightnine
XVZSYVKBXQMVZF -> seveneightfive
XVZSYVKBXQMPAS -> seveneightfour
XVZSYVKBXQSZDV -> seveneightzero
XVZSYHOMAWEVHF -> sevensevennine
XVZSYHOMAWMVZF -> sevensevenfive
XVZSYHOMAWMPAS -> sevensevenfour
XVZSYHOMAWSZDV -> sevensevenzero
XVZSYUKMAFJXNQ -> sevenfiveeight
XVZSYUKMARNIQW -> sevenfiveseven
XVZSYUKMAQKMQF -> sevenfivethree
XVZSYUENNFJXNQ -> sevenfoureight
XVZSYUENNRNIQW -> sevenfourseven
XVZSYUENNQKMQF -> sevenfourthree
XVZSYGLQAFEVHF -> seventhreenine
XVZSYGLQAFMVZF -> seventhreefive
XVZSYGLQAFMPAS -> seventhreefour
XVZSYGLQAFSZDV -> seventhreezero
XVZSYAOQQFJXNQ -> sevenzeroeight
XVZSYAOQQRNIQW -> sevenzeroseven
XVZSYAOQQQKMQF -> sevenzerothree
KRZSHRMALFJXNQ -> fiveeighteight
KRZSHRMALRNIQW -> fiveeightseven
KRZSHRMALQKMQF -> fiveeightthree
KRZSTVXDRFJXNQ -> fiveseveneight
KRZSTVXDRRNIQW -> fivesevenseven
KRZSTVXDRQKMQF -> fiveseventhree
KRZSSSBDAFJXNQ -> fivethreeeight
KRZSSSBDARNIQW -> fivethreeseven
KRZSSSBDAQKMQF -> fivethreethree
KLAFHRMALFJXNQ -> foureighteight
KLAFHRMALRNIQW -> foureightseven
KLAFHRMALQKMQF -> foureightthree
KLAFTVXDRFJXNQ -> fourseveneight
KLAFTVXDRRNIQW -> foursevenseven
KLAFTVXDRQKMQF -> fourseventhree
KLAFSSBDAFJXNQ -> fourthreeeight
KLAFSSBDARNIQW -> fourthreeseven
KLAFSSBDAQKMQF -> fourthreethree
WSDSHMKUAFJXNQ -> threenineeight
WSDSHMKUARNIQW -> threenineseven
WSDSHMKUAQKMQF -> threeninethree
WSDSHVKBXQEVHF -> threeeightnine
WSDSHVKBXQMVZF -> threeeightfive
WSDSHVKBXQMPAS -> threeeightfour
WSDSHVKBXQSZDV -> threeeightzero
WSDSHHOMAWEVHF -> threesevennine
WSDSHHOMAWMVZF -> threesevenfive
WSDSHHOMAWMPAS -> threesevenfour
WSDSHHOMAWSZDV -> threesevenzero
WSDSHUKMAFJXNQ -> threefiveeight
WSDSHUKMARNIQW -> threefiveseven
WSDSHUKMAQKMQF -> threefivethree
WSDSHUENNFJXNQ -> threefoureight
WSDSHUENNRNIQW -> threefourseven
WSDSHUENNQKMQF -> threefourthree
WSDSHGLQAFEVHF -> threethreenine
WSDSHGLQAFMVZF -> threethreefive
WSDSHGLQAFMPAS -> threethreefour
WSDSHGLQAFSZDV -> threethreezero
WSDSHAOQQFJXNQ -> threezeroeight
WSDSHAOQQRNIQW -> threezeroseven
WSDSHAOQQQKMQF -> threezerothree
QVDIHRMALFJXNQ -> zeroeighteight
QVDIHRMALRNIQW -> zeroeightseven
QVDIHRMALQKMQF -> zeroeightthree
QVDITVXDRFJXNQ -> zeroseveneight
QVDITVXDRRNIQW -> zerosevenseven
QVDITVXDRQKMQF -> zeroseventhree
QVDISSBDAFJXNQ -> zerothreeeight
QVDISSBDARNIQW -> zerothreeseven
QVDISSBDAQKMQF -> zerothreethree

OWYWVGQWPQWO -> nineninenine
OWYWVGQWXQOO -> nineninefive
OWYWVGQWXKPB -> nineninefour
OWYWVGQWDUSE -> nineninezero
OWYWEGXTJGBV -> nineeightsix
OWYWEGXTJFNE -> nineeighttwo
OWYWEGXTJKWO -> nineeightone
OWYWQKIWPGBV -> ninesevensix
OWYWQKIWPFNE -> nineseventwo
OWYWQKIWPKWO -> ninesevenone
OWYWQGGWUSCZ -> ninesixeight
OWYWQGGIYDFF -> ninesixseven
OWYWQGGHVHFO -> ninesixthree
OWYWDGIWPQWO -> ninefivenine
OWYWDGIWXQOO -> ninefivefive
OWYWDGIWXKPB -> ninefivefour
OWYWDGIWDUSE -> ninefivezero
OWYWDAJJPQWO -> ninefournine
OWYWDAJJXQOO -> ninefourfive
OWYWDAJJXKPB -> ninefourfour
OWYWDAJJDUSE -> ninefourzero
OWYWPHMWYGBV -> ninethreesix
OWYWPHMWYFNE -> ninethreetwo
OWYWPHMWYKWO -> ninethreeone
OWYWPSPWUSCZ -> ninetwoeight
OWYWPSPIYDFF -> ninetwoseven
OWYWPSPHVHFO -> ninetwothree
OWYWUBZWUSCZ -> nineoneeight
OWYWUBZIYDFF -> nineoneseven
OWYWUBZHVHFO -> nineonethree
OWYWJKMMPQWO -> ninezeronine
OWYWJKMMXQOO -> ninezerofive
OWYWJKMMXKPB -> ninezerofour
OWYWJKMMDUSE -> ninezerozero
XWFTPBVNYGBV -> eightninesix
XWFTPBVNYFNE -> eightninetwo
XWFTPBVNYKWO -> eightnineone
XWFTPWVDPQWO -> eightsixnine
XWFTPWVDXQOO -> eightsixfive
XWFTPWVDXKPB -> eightsixfour
XWFTPWVDDUSE -> eightsixzero
XWFTPJVFYGBV -> eightfivesix
XWFTPJVFYFNE -> eightfivetwo
XWFTPJVFYKWO -> eightfiveone
XWFTPJPGLGBV -> eightfoursix
XWFTPJPGLFNE -> eightfourtwo
XWFTPJPGLKWO -> eightfourone
XWFTPVHMPQWO -> eighttwonine
XWFTPVHMXQOO -> eighttwofive
XWFTPVHMXKPB -> eighttwofour
XWFTPVHMDUSE -> eighttwozero
XWFTPAQWPQWO -> eightonenine
XWFTPAQWXQOO -> eightonefive
XWFTPAQWXKPB -> eightonefour
XWFTPAQWDUSE -> eightonezero
XWFTPPZJOGBV -> eightzerosix
XWFTPPZJOFNE -> eightzerotwo
XWFTPPZJOKWO -> eightzeroone
JAQWVBVNYGBV -> sevenninesix
JAQWVBVNYFNE -> sevenninetwo
JAQWVBVNYKWO -> sevennineone
JAQWVWVDPQWO -> sevensixnine
JAQWVWVDXQOO -> sevensixfive
JAQWVWVDXKPB -> sevensixfour
JAQWVWVDDUSE -> sevensixzero
JAQWVJVFYGBV -> sevenfivesix
JAQWVJVFYFNE -> sevenfivetwo
JAQWVJVFYKWO -> sevenfiveone
JAQWVJPGLGBV -> sevenfoursix
JAQWVJPGLFNE -> sevenfourtwo
JAQWVJPGLKWO -> sevenfourone
JAQWVVHMPQWO -> seventwonine
JAQWVVHMXQOO -> seventwofive
JAQWVVHMXKPB -> seventwofour
JAQWVVHMDUSE -> seventwozero
JAQWVAQWPQWO -> sevenonenine
JAQWVAQWXQOO -> sevenonefive
JAQWVAQWXKPB -> sevenonefour
JAQWVAQWDUSE -> sevenonezero
JAQWVPZJOGBV -> sevenzerosix
JAQWVPZJOFNE -> sevenzerotwo
JAQWVPZJOKWO -> sevenzeroone
JWONABZWUSCZ -> sixnineeight
JWONABZIYDFF -> sixnineseven
JWONABZHVHFO -> sixninethree
JWOWAIWHPQWO -> sixeightnine
JWOWAIWHXQOO -> sixeightfive
JWOWAIWHXKPB -> sixeightfour
JWOWAIWHDUSE -> sixeightzero
JWOIETZNPQWO -> sixsevennine
JWOIETZNXQOO -> sixsevenfive
JWOIETZNXKPB -> sixsevenfour
JWOIETZNDUSE -> sixsevenzero
JWOVATZWUSCZ -> sixfiveeight
JWOVATZIYDFF -> sixfiveseven
JWOVATZHVHFO -> sixfivethree
JWOVUUMWUSCZ -> sixfoureight
JWOVUUMIYDFF -> sixfourseven
JWOVUUMHVHFO -> sixfourthree
JWOHBXZWPQWO -> sixthreenine
JWOHBXZWXQOO -> sixthreefive
JWOHBXZWXKPB -> sixthreefour
JWOHBXZWDUSE -> sixthreezero
JWOBEXPWUSCZ -> sixzeroeight
JWOBEXPIYDFF -> sixzeroseven
JWOBEXPHVHFO -> sixzerothree
WWQWVGQWPQWO -> fiveninenine
WWQWVGQWXQOO -> fiveninefive
WWQWVGQWXKPB -> fiveninefour
WWQWVGQWDUSE -> fiveninezero
WWQWEGXTJGBV -> fiveeightsix
WWQWEGXTJFNE -> fiveeighttwo
WWQWEGXTJKWO -> fiveeightone
WWQWQKIWPGBV -> fivesevensix
WWQWQKIWPFNE -> fiveseventwo
WWQWQKIWPKWO -> fivesevenone
WWQWQGGWUSCZ -> fivesixeight
WWQWQGGIYDFF -> fivesixseven
WWQWQGGHVHFO -> fivesixthree
WWQWDGIWPQWO -> fivefivenine
WWQWDGIWXQOO -> fivefivefive
WWQWDGIWXKPB -> fivefivefour
WWQWDGIWDUSE -> fivefivezero
WWQWDAJJPQWO -> fivefournine
WWQWDAJJXQOO -> fivefourfive
WWQWDAJJXKPB -> fivefourfour
WWQWDAJJDUSE -> fivefourzero
WWQWPHMWYGBV -> fivethreesix
WWQWPHMWYFNE -> fivethreetwo
WWQWPHMWYKWO -> fivethreeone
WWQWPSPWUSCZ -> fivetwoeight
WWQWPSPIYDFF -> fivetwoseven
WWQWPSPHVHFO -> fivetwothree
WWQWUBZWUSCZ -> fiveoneeight
WWQWUBZIYDFF -> fiveoneseven
WWQWUBZHVHFO -> fiveonethree
WWQWJKMMPQWO -> fivezeronine
WWQWJKMMXQOO -> fivezerofive
WWQWJKMMXKPB -> fivezerofour
WWQWJKMMDUSE -> fivezerozero
WQRJVGQWPQWO -> fourninenine
WQRJVGQWXQOO -> fourninefive
WQRJVGQWXKPB -> fourninefour
WQRJVGQWDUSE -> fourninezero
WQRJEGXTJGBV -> foureightsix
WQRJEGXTJFNE -> foureighttwo
WQRJEGXTJKWO -> foureightone
WQRJQKIWPGBV -> foursevensix
WQRJQKIWPFNE -> fourseventwo
WQRJQKIWPKWO -> foursevenone
WQRJQGGWUSCZ -> foursixeight
WQRJQGGIYDFF -> foursixseven
WQRJQGGHVHFO -> foursixthree
WQRJDGIWPQWO -> fourfivenine
WQRJDGIWXQOO -> fourfivefive
WQRJDGIWXKPB -> fourfivefour
WQRJDGIWDUSE -> fourfivezero
WQRJDAJJPQWO -> fourfournine
WQRJDAJJXQOO -> fourfourfive
WQRJDAJJXKPB -> fourfourfour
WQRJDAJJDUSE -> fourfourzero
WQRJPHMWYGBV -> fourthreesix
WQRJPHMWYFNE -> fourthreetwo
WQRJPHMWYKWO -> fourthreeone
WQRJPSPWUSCZ -> fourtwoeight
WQRJPSPIYDFF -> fourtwoseven
WQRJPSPHVHFO -> fourtwothree
WQRJUBZWUSCZ -> fouroneeight
WQRJUBZIYDFF -> fouroneseven
WQRJUBZHVHFO -> fouronethree
WQRJJKMMPQWO -> fourzeronine
WQRJJKMMXQOO -> fourzerofive
WQRJJKMMXKPB -> fourzerofour
WQRJJKMMDUSE -> fourzerozero
IXUWEBVNYGBV -> threeninesix
IXUWEBVNYFNE -> threeninetwo
IXUWEBVNYKWO -> threenineone
IXUWEWVDPQWO -> threesixnine
IXUWEWVDXQOO -> threesixfive
IXUWEWVDXKPB -> threesixfour
IXUWEWVDDUSE -> threesixzero
IXUWEJVFYGBV -> threefivesix
IXUWEJVFYFNE -> threefivetwo
IXUWEJVFYKWO -> threefiveone
IXUWEJPGLGBV -> threefoursix
IXUWEJPGLFNE -> threefourtwo
IXUWEJPGLKWO -> threefourone
IXUWEVHMPQWO -> threetwonine
IXUWEVHMXQOO -> threetwofive
IXUWEVHMXKPB -> threetwofour
IXUWEVHMDUSE -> threetwozero
IXUWEAQWPQWO -> threeonenine
IXUWEAQWXQOO -> threeonefive
IXUWEAQWXKPB -> threeonefour
IXUWEAQWDUSE -> threeonezero
IXUWEPZJOGBV -> threezerosix
IXUWEPZJOFNE -> threezerotwo
IXUWEPZJOKWO -> threezeroone
IIXNABZWUSCZ -> twonineeight
IIXNABZIYDFF -> twonineseven
IIXNABZHVHFO -> twoninethree
IIXWAIWHPQWO -> twoeightnine
IIXWAIWHXQOO -> twoeightfive
IIXWAIWHXKPB -> twoeightfour
IIXWAIWHDUSE -> twoeightzero
IIXIETZNPQWO -> twosevennine
IIXIETZNXQOO -> twosevenfive
IIXIETZNXKPB -> twosevenfour
IIXIETZNDUSE -> twosevenzero
IIXVATZWUSCZ -> twofiveeight
IIXVATZIYDFF -> twofiveseven
IIXVATZHVHFO -> twofivethree
IIXVUUMWUSCZ -> twofoureight
IIXVUUMIYDFF -> twofourseven
IIXVUUMHVHFO -> twofourthree
IIXHBXZWPQWO -> twothreenine
IIXHBXZWXQOO -> twothreefive
IIXHBXZWXKPB -> twothreefour
IIXHBXZWDUSE -> twothreezero
IIXBEXPWUSCZ -> twozeroeight
IIXBEXPIYDFF -> twozeroseven
IIXBEXPHVHFO -> twozerothree
NRHNABZWUSCZ -> onenineeight
NRHNABZIYDFF -> onenineseven
NRHNABZHVHFO -> oneninethree
NRHWAIWHPQWO -> oneeightnine
NRHWAIWHXQOO -> oneeightfive
NRHWAIWHXKPB -> oneeightfour
NRHWAIWHDUSE -> oneeightzero
NRHIETZNPQWO -> onesevennine
NRHIETZNXQOO -> onesevenfive
NRHIETZNXKPB -> onesevenfour
NRHIETZNDUSE -> onesevenzero
NRHVATZWUSCZ -> onefiveeight
NRHVATZIYDFF -> onefiveseven
NRHVATZHVHFO -> onefivethree
NRHVUUMWUSCZ -> onefoureight
NRHVUUMIYDFF -> onefourseven
NRHVUUMHVHFO -> onefourthree
NRHHBXZWPQWO -> onethreenine
NRHHBXZWXQOO -> onethreefive
NRHHBXZWXKPB -> onethreefour
NRHHBXZWDUSE -> onethreezero
NRHBEXPWUSCZ -> onezeroeight
NRHBEXPIYDFF -> onezeroseven
NRHBEXPHVHFO -> onezerothree
CAUMVGQWPQWO -> zeroninenine
CAUMVGQWXQOO -> zeroninefive
CAUMVGQWXKPB -> zeroninefour
CAUMVGQWDUSE -> zeroninezero
CAUMEGXTJGBV -> zeroeightsix
CAUMEGXTJFNE -> zeroeighttwo
CAUMEGXTJKWO -> zeroeightone
CAUMQKIWPGBV -> zerosevensix
CAUMQKIWPFNE -> zeroseventwo
CAUMQKIWPKWO -> zerosevenone
CAUMQGGWUSCZ -> zerosixeight
CAUMQGGIYDFF -> zerosixseven
CAUMQGGHVHFO -> zerosixthree
CAUMDGIWPQWO -> zerofivenine
CAUMDGIWXQOO -> zerofivefive
CAUMDGIWXKPB -> zerofivefour
CAUMDGIWDUSE -> zerofivezero
CAUMDAJJPQWO -> zerofournine
CAUMDAJJXQOO -> zerofourfive
CAUMDAJJXKPB -> zerofourfour
CAUMDAJJDUSE -> zerofourzero
CAUMPHMWYGBV -> zerothreesix
CAUMPHMWYFNE -> zerothreetwo
CAUMPHMWYKWO -> zerothreeone
CAUMPSPWUSCZ -> zerotwoeight
CAUMPSPIYDFF -> zerotwoseven
CAUMPSPHVHFO -> zerotwothree
CAUMUBZWUSCZ -> zerooneeight
CAUMUBZIYDFF -> zerooneseven
CAUMUBZHVHFO -> zeroonethree
CAUMJKMMPQWO -> zerozeronine
CAUMJKMMXQOO -> zerozerofive
CAUMJKMMXKPB -> zerozerofour
CAUMJKMMDUSE -> zerozerozero

EPQTLVRCRVJI -> nineninenine
EPQTLVRCZVBI -> nineninefive
EPQTLVRCZPCV -> nineninefour
EPQTLVRCFZFY -> nineninezero
EPQTUVYZLLOP -> nineeightsix
EPQTUVYZLKAY -> nineeighttwo
EPQTUVYZLPJI -> nineeightone
EPQTGZJCRLOP -> ninesevensix
EPQTGZJCRKAY -> nineseventwo
EPQTGZJCRPJI -> ninesevenone
EPQTGVHCWXPT -> ninesixeight
EPQTGVHOAISZ -> ninesixseven
EPQTGVHNXMSI -> ninesixthree
EPQTTVJCRVJI -> ninefivenine
EPQTTVJCZVBI -> ninefivefive
EPQTTVJCZPCV -> ninefivefour
EPQTTVJCFZFY -> ninefivezero
EPQTTPKPRVJI -> ninefournine
EPQTTPKPZVBI -> ninefourfive
EPQTTPKPZPCV -> ninefourfour
EPQTTPKPFZFY -> ninefourzero
EPQTFWNCALOP -> ninethreesix
EPQTFWNCAKAY -> ninethreetwo
EPQTFWNCAPJI -> ninethreeone
EPQTFHQCWXPT -> ninetwoeight
EPQTFHQOAISZ -> ninetwoseven
EPQTFHQNXMSI -> ninetwothree
EPQTKQACWXPT -> nineoneeight
EPQTKQAOAISZ -> nineoneseven
EPQTKQANXMSI -> nineonethree
EPQTZZNSRVJI -> ninezeronine
EPQTZZNSZVBI -> ninezerofive
EPQTZZNSZPCV -> ninezerofour
EPQTZZNSFZFY -> ninezerozero
NPXQFQWTALOP -> eightninesix
NPXQFQWTAKAY -> eightninetwo
NPXQFQWTAPJI -> eightnineone
NPXQFLWJRVJI -> eightsixnine
NPXQFLWJZVBI -> eightsixfive
NPXQFLWJZPCV -> eightsixfour
NPXQFLWJFZFY -> eightsixzero
NPXQFYWLALOP -> eightfivesix
NPXQFYWLAKAY -> eightfivetwo
NPXQFYWLAPJI -> eightfiveone
NPXQFYQMNLOP -> eightfoursix
NPXQFYQMNKAY -> eightfourtwo
NPXQFYQMNPJI -> eightfourone
NPXQFKISRVJI -> eighttwonine
NPXQFKISZVBI -> eighttwofive
NPXQFKISZPCV -> eighttwofour
NPXQFKISFZFY -> eighttwozero
NPXQFPRCRVJI -> eightonenine
NPXQFPRCZVBI -> eightonefive
NPXQFPRCZPCV -> eightonefour
NPXQFPRCFZFY -> eightonezero
NPXQFEAPQLOP -> eightzerosix
NPXQFEAPQKAY -> eightzerotwo
NPXQFEAPQPJI -> eightzeroone
ZTITLQWTALOP -> sevenninesix
ZTITLQWTAKAY -> sevenninetwo
ZTITLQWTAPJI -> sevennineone
ZTITLLWJRVJI -> sevensixnine
ZTITLLWJZVBI -> sevensixfive
ZTITLLWJZPCV -> sevensixfour
ZTITLLWJFZFY -> sevensixzero
ZTITLYWLALOP -> sevenfivesix
ZTITLYWLAKAY -> sevenfivetwo
ZTITLYWLAPJI -> sevenfiveone
ZTITLYQMNLOP -> sevenfoursix
ZTITLYQMNKAY -> sevenfourtwo
ZTITLYQMNPJI -> sevenfourone
ZTITLKISRVJI -> seventwonine
ZTITLKISZVBI -> seventwofive
ZTITLKISZPCV -> seventwofour
ZTITLKISFZFY -> seventwozero
ZTITLPRCRVJI -> sevenonenine
ZTITLPRCZVBI -> sevenonefive
ZTITLPRCZPCV -> sevenonefour
ZTITLPRCFZFY -> sevenonezero
ZTITLEAPQLOP -> sevenzerosix
ZTITLEAPQKAY -> sevenzerotwo
ZTITLEAPQPJI -> sevenzeroone
ZPGKQQACWXPT -> sixnineeight
ZPGKQQAOAISZ -> sixnineseven
ZPGKQQANXMSI -> sixninethree
ZPGTQXXNRVJI -> sixeightnine
ZPGTQXXNZVBI -> sixeightfive
ZPGTQXXNZPCV -> sixeightfour
ZPGTQXXNFZFY -> sixeightzero
ZPGFUIATRVJI -> sixsevennine
ZPGFUIATZVBI -> sixsevenfive
ZPGFUIATZPCV -> sixsevenfour
ZPGFUIATFZFY -> sixsevenzero
ZPGSQIACWXPT -> sixfiveeight
ZPGSQIAOAISZ -> sixfiveseven
ZPGSQIANXMSI -> sixfivethree
ZPGSKJNCWXPT -> sixfoureight
ZPGSKJNOAISZ -> sixfourseven
ZPGSKJNNXMSI -> sixfourthree
ZPGERMACRVJI -> sixthreenine
ZPGERMACZVBI -> sixthreefive
ZPGERMACZPCV -> sixthreefour
ZPGERMACFZFY -> sixthreezero
ZPGYUMQCWXPT -> sixzeroeight
ZPGYUMQOAISZ -> sixzeroseven
ZPGYUMQNXMSI -> sixzerothree
MPITLVRCRVJI -> fiveninenine
MPITLVRCZVBI -> fiveninefive
MPITLVRCZPCV -> fiveninefour
MPITLVRCFZFY -> fiveninezero
MPITUVYZLLOP -> fiveeightsix
MPITUVYZLKAY -> fiveeighttwo
MPITUVYZLPJI -> fiveeightone
MPITGZJCRLOP -> fivesevensix
MPITGZJCRKAY -> fiveseventwo
MPITGZJCRPJI -> fivesevenone
MPITGVHCWXPT -> fivesixeight
MPITGVHOAISZ -> fivesixseven
MPITGVHNXMSI -> fivesixthree
MPITTVJCRVJI -> fivefivenine
MPITTVJCZVBI -> fivefivefive
MPITTVJCZPCV -> fivefivefour
MPITTVJCFZFY -> fivefivezero
MPITTPKPRVJI -> fivefournine
MPITTPKPZVBI -> fivefourfive
MPITTPKPZPCV -> fivefourfour
MPITTPKPFZFY -> fivefourzero
MPITFWNCALOP -> fivethreesix
MPITFWNCAKAY -> fivethreetwo
MPITFWNCAPJI -> fivethreeone
MPITFHQCWXPT -> fivetwoeight
MPITFHQOAISZ -> fivetwoseven
MPITFHQNXMSI -> fivetwothree
MPITKQACWXPT -> fiveoneeight
MPITKQAOAISZ -> fiveoneseven
MPITKQANXMSI -> fiveonethree
MPITZZNSRVJI -> fivezeronine
MPITZZNSZVBI -> fivezerofive
MPITZZNSZPCV -> fivezerofour
MPITZZNSFZFY -> fivezerozero
MJJGLVRCRVJI -> fourninenine
MJJGLVRCZVBI -> fourninefive
MJJGLVRCZPCV -> fourninefour
MJJGLVRCFZFY -> fourninezero
MJJGUVYZLLOP -> foureightsix
MJJGUVYZLKAY -> foureighttwo
MJJGUVYZLPJI -> foureightone
MJJGGZJCRLOP -> foursevensix
MJJGGZJCRKAY -> fourseventwo
MJJGGZJCRPJI -> foursevenone
MJJGGVHCWXPT -> foursixeight
MJJGGVHOAISZ -> foursixseven
MJJGGVHNXMSI -> foursixthree
MJJGTVJCRVJI -> fourfivenine
MJJGTVJCZVBI -> fourfivefive
MJJGTVJCZPCV -> fourfivefour
MJJGTVJCFZFY -> fourfivezero
MJJGTPKPRVJI -> fourfournine
MJJGTPKPZVBI -> fourfourfive
MJJGTPKPZPCV -> fourfourfour
MJJGTPKPFZFY -> fourfourzero
MJJGFWNCALOP -> fourthreesix
MJJGFWNCAKAY -> fourthreetwo
MJJGFWNCAPJI -> fourthreeone
MJJGFHQCWXPT -> fourtwoeight
MJJGFHQOAISZ -> fourtwoseven
MJJGFHQNXMSI -> fourtwothree
MJJGKQACWXPT -> fouroneeight
MJJGKQAOAISZ -> fouroneseven
MJJGKQANXMSI -> fouronethree
MJJGZZNSRVJI -> fourzeronine
MJJGZZNSZVBI -> fourzerofive
MJJGZZNSZPCV -> fourzerofour
MJJGZZNSFZFY -> fourzerozero
YQMTUQWTALOP -> threeninesix
YQMTUQWTAKAY -> threeninetwo
YQMTUQWTAPJI -> threenineone
YQMTULWJRVJI -> threesixnine
YQMTULWJZVBI -> threesixfive
YQMTULWJZPCV -> threesixfour
YQMTULWJFZFY -> threesixzero
YQMTUYWLALOP -> threefivesix
YQMTUYWLAKAY -> threefivetwo
YQMTUYWLAPJI -> threefiveone
YQMTUYQMNLOP -> threefoursix
YQMTUYQMNKAY -> threefourtwo
YQMTUYQMNPJI -> threefourone
YQMTUKISRVJI -> threetwonine
YQMTUKISZVBI -> threetwofive
YQMTUKISZPCV -> threetwofour
YQMTUKISFZFY -> threetwozero
YQMTUPRCRVJI -> threeonenine
YQMTUPRCZVBI -> threeonefive
YQMTUPRCZPCV -> threeonefour
YQMTUPRCFZFY -> threeonezero
YQMTUEAPQLOP -> threezerosix
YQMTUEAPQKAY -> threezerotwo
YQMTUEAPQPJI -> threezeroone
YBPKQQACWXPT -> twonineeight
YBPKQQAOAISZ -> twonineseven
YBPKQQANXMSI -> twoninethree
YBPTQXXNRVJI -> twoeightnine
YBPTQXXNZVBI -> twoeightfive
YBPTQXXNZPCV -> twoeightfour
YBPTQXXNFZFY -> twoeightzero
YBPFUIATRVJI -> twosevennine
YBPFUIATZVBI -> twosevenfive
YBPFUIATZPCV -> twosevenfour
YBPFUIATFZFY -> twosevenzero
YBPSQIACWXPT -> twofiveeight
YBPSQIAOAISZ -> twofiveseven
YBPSQIANXMSI -> twofivethree
YBPSKJNCWXPT -> twofoureight
YBPSKJNOAISZ -> twofourseven
YBPSKJNNXMSI -> twofourthree
YBPERMACRVJI -> twothreenine
YBPERMACZVBI -> twothreefive
YBPERMACZPCV -> twothreefour
YBPERMACFZFY -> twothreezero
YBPYUMQCWXPT -> twozeroeight
YBPYUMQOAISZ -> twozeroseven
YBPYUMQNXMSI -> twozerothree
DKZKQQACWXPT -> onenineeight
DKZKQQAOAISZ -> onenineseven
DKZKQQANXMSI -> oneninethree
DKZTQXXNRVJI -> oneeightnine
DKZTQXXNZVBI -> oneeightfive
DKZTQXXNZPCV -> oneeightfour
DKZTQXXNFZFY -> oneeightzero
DKZFUIATRVJI -> onesevennine
DKZFUIATZVBI -> onesevenfive
DKZFUIATZPCV -> onesevenfour
DKZFUIATFZFY -> onesevenzero
DKZSQIACWXPT -> onefiveeight
DKZSQIAOAISZ -> onefiveseven
DKZSQIANXMSI -> onefivethree
DKZSKJNCWXPT -> onefoureight
DKZSKJNOAISZ -> onefourseven
DKZSKJNNXMSI -> onefourthree
DKZERMACRVJI -> onethreenine
DKZERMACZVBI -> onethreefive
DKZERMACZPCV -> onethreefour
DKZERMACFZFY -> onethreezero
DKZYUMQCWXPT -> onezeroeight
DKZYUMQOAISZ -> onezeroseven
DKZYUMQNXMSI -> onezerothree
STMJLVRCRVJI -> zeroninenine
STMJLVRCZVBI -> zeroninefive
STMJLVRCZPCV -> zeroninefour
STMJLVRCFZFY -> zeroninezero
STMJUVYZLLOP -> zeroeightsix
STMJUVYZLKAY -> zeroeighttwo
STMJUVYZLPJI -> zeroeightone
STMJGZJCRLOP -> zerosevensix
STMJGZJCRKAY -> zeroseventwo
STMJGZJCRPJI -> zerosevenone
STMJGVHCWXPT -> zerosixeight
STMJGVHOAISZ -> zerosixseven
STMJGVHNXMSI -> zerosixthree
STMJTVJCRVJI -> zerofivenine
STMJTVJCZVBI -> zerofivefive
STMJTVJCZPCV -> zerofivefour
STMJTVJCFZFY -> zerofivezero
STMJTPKPRVJI -> zerofournine
STMJTPKPZVBI -> zerofourfive
STMJTPKPZPCV -> zerofourfour
STMJTPKPFZFY -> zerofourzero
STMJFWNCALOP -> zerothreesix
STMJFWNCAKAY -> zerothreetwo
STMJFWNCAPJI -> zerothreeone
STMJFHQCWXPT -> zerotwoeight
STMJFHQOAISZ -> zerotwoseven
STMJFHQNXMSI -> zerotwothree
STMJKQACWXPT -> zerooneeight
STMJKQAOAISZ -> zerooneseven
STMJKQANXMSI -> zeroonethree
STMJZZNSRVJI -> zerozeronine
STMJZZNSZVBI -> zerozerofive
STMJZZNSZPCV -> zerozerofour
STMJZZNSFZFY -> zerozerozero

SNPHBMEEKYOLYKS -> eighteighteight
SNPHBMEEKYAPJNY -> eighteightseven
SNPHBMEEKYZMNNH -> eighteightthree
SNPHBYIPNEOLYKS -> eightseveneight
SNPHBYIPNEAPJNY -> eightsevenseven
SNPHBYIPNEZMNNH -> eightseventhree
SNPHBXFTNNOLYKS -> eightthreeeight
SNPHBXFTNNAPJNY -> eightthreeseven
SNPHBXFTNNZMNNH -> eightthreethree
ERAKHMEEKYOLYKS -> seveneighteight
ERAKHMEEKYAPJNY -> seveneightseven
ERAKHMEEKYZMNNH -> seveneightthree
ERAKHYIPNEOLYKS -> sevenseveneight
ERAKHYIPNEAPJNY -> sevensevenseven
ERAKHYIPNEZMNNH -> sevenseventhree
ERAKHXFTNNOLYKS -> seventhreeeight
ERAKHXFTNNAPJNY -> seventhreeseven
ERAKHXFTNNZMNNH -> seventhreethree
DOEKQMEEKYOLYKS -> threeeighteight
DOEKQMEEKYAPJNY -> threeeightseven
DOEKQMEEKYZMNNH -> threeeightthree
DOEKQYIPNEOLYKS -> threeseveneight
DOEKQYIPNEAPJNY -> threesevenseven
DOEKQYIPNEZMNNH -> threeseventhree
DOEKQXFTNNOLYKS -> threethreeeight
DOEKQXFTNNAPJNY -> threethreeseven
DOEKQXFTNNZMNNH -> threethreethree

CIQIIGBVLKF -> nineninesix
CIQIIGBVKWO -> nineninetwo
CIQIIGBVPFY -> ninenineone
CIQIDGRMVFY -> ninesixnine
CIQIDGRUVXY -> ninesixfive
CIQIDGRUPYL -> ninesixfour
CIQIDGRAZBO -> ninesixzero
CIQIQGTVLKF -> ninefivesix
CIQIQGTVKWO -> ninefivetwo
CIQIQGTVPFY -> ninefiveone
CIQIQAUILKF -> ninefoursix
CIQIQAUIKWO -> ninefourtwo
CIQIQAUIPFY -> ninefourone
CIQICSAMVFY -> ninetwonine
CIQICSAUVXY -> ninetwofive
CIQICSAUPYL -> ninetwofour
CIQICSAAZBO -> ninetwozero
CIQIHBKMVFY -> nineonenine
CIQIHBKUVXY -> nineonefive
CIQIHBKUPYL -> nineonefour
CIQIHBKAZBO -> nineonezero
CIQIWKXLLKF -> ninezerosix
CIQIWKXLKWO -> ninezerotwo
CIQIWKXLPFY -> ninezeroone
LIXFCWGCLKF -> eightsixsix
LIXFCWGCKWO -> eightsixtwo
LIXFCWGCPFY -> eightsixone
LIXFCVSLLKF -> eighttwosix
LIXFCVSLKWO -> eighttwotwo
LIXFCVSLPFY -> eighttwoone
LIXFCABVLKF -> eightonesix
LIXFCABVKWO -> eightonetwo
LIXFCABVPFY -> eightoneone
XMIIIWGCLKF -> sevensixsix
XMIIIWGCKWO -> sevensixtwo
XMIIIWGCPFY -> sevensixone
XMIIIVSLLKF -> seventwosix
XMIIIVSLKWO -> seventwotwo
XMIIIVSLPFY -> seventwoone
XMIIIABVLKF -> sevenonesix
XMIIIABVKWO -> sevenonetwo
XMIIIABVPFY -> sevenoneone
XIGZNBKMVFY -> sixninenine
XIGZNBKUVXY -> sixninefive
XIGZNBKUPYL -> sixninefour
XIGZNBKAZBO -> sixninezero
XIGINIHGLKF -> sixeightsix
XIGINIHGKWO -> sixeighttwo
XIGINIHGPFY -> sixeightone
XIGURTKMLKF -> sixsevensix
XIGURTKMKWO -> sixseventwo
XIGURTKMPFY -> sixsevenone
XIGUNRKRXLJ -> sixsixeight
XIGUNRWVIOP -> sixsixseven
XIGUNRVSMOY -> sixsixthree
XIGHNTKMVFY -> sixfivenine
XIGHNTKUVXY -> sixfivefive
XIGHNTKUPYL -> sixfivefour
XIGHNTKAZBO -> sixfivezero
XIGHHUXMVFY -> sixfournine
XIGHHUXUVXY -> sixfourfive
XIGHHUXUPYL -> sixfourfour
XIGHHUXAZBO -> sixfourzero
XIGTOXKVLKF -> sixthreesix
XIGTOXKVKWO -> sixthreetwo
XIGTOXKVPFY -> sixthreeone
XIGTZAKRXLJ -> sixtwoeight
XIGTZAWVIOP -> sixtwoseven
XIGTZAVSMOY -> sixtwothree
XIGYIKKRXLJ -> sixoneeight
XIGYIKWVIOP -> sixoneseven
XIGYIKVSMOY -> sixonethree
XIGNRXAMVFY -> sixzeronine
XIGNRXAUVXY -> sixzerofive
XIGNRXAUPYL -> sixzerofour
XIGNRXAAZBO -> sixzerozero
KIIIIGBVLKF -> fiveninesix
KIIIIGBVKWO -> fiveninetwo
KIIIIGBVPFY -> fivenineone
KIIIDGRMVFY -> fivesixnine
KIIIDGRUVXY -> fivesixfive
KIIIDGRUPYL -> fivesixfour
KIIIDGRAZBO -> fivesixzero
KIIIQGTVLKF -> fivefivesix
KIIIQGTVKWO -> fivefivetwo
KIIIQGTVPFY -> fivefiveone
KIIIQAUILKF -> fivefoursix
KIIIQAUIKWO -> fivefourtwo
KIIIQAUIPFY -> fivefourone
KIIICSAMVFY -> fivetwonine
KIIICSAUVXY -> fivetwofive
KIIICSAUPYL -> fivetwofour
KIIICSAAZBO -> fivetwozero
KIIIHBKMVFY -> fiveonenine
KIIIHBKUVXY -> fiveonefive
KIIIHBKUPYL -> fiveonefour
KIIIHBKAZBO -> fiveonezero
KIIIWKXLLKF -> fivezerosix
KIIIWKXLKWO -> fivezerotwo
KIIIWKXLPFY -> fivezeroone
KCJVIGBVLKF -> fourninesix
KCJVIGBVKWO -> fourninetwo
KCJVIGBVPFY -> fournineone
KCJVDGRMVFY -> foursixnine
KCJVDGRUVXY -> foursixfive
KCJVDGRUPYL -> foursixfour
KCJVDGRAZBO -> foursixzero
KCJVQGTVLKF -> fourfivesix
KCJVQGTVKWO -> fourfivetwo
KCJVQGTVPFY -> fourfiveone
KCJVQAUILKF -> fourfoursix
KCJVQAUIKWO -> fourfourtwo
KCJVQAUIPFY -> fourfourone
KCJVCSAMVFY -> fourtwonine
KCJVCSAUVXY -> fourtwofive
KCJVCSAUPYL -> fourtwofour
KCJVCSAAZBO -> fourtwozero
KCJVHBKMVFY -> fouronenine
KCJVHBKUVXY -> fouronefive
KCJVHBKUPYL -> fouronefour
KCJVHBKAZBO -> fouronezero
KCJVWKXLLKF -> fourzerosix
KCJVWKXLKWO -> fourzerotwo
KCJVWKXLPFY -> fourzeroone
WJMIRWGCLKF -> threesixsix
WJMIRWGCKWO -> threesixtwo
WJMIRWGCPFY -> threesixone
WJMIRVSLLKF -> threetwosix
WJMIRVSLKWO -> threetwotwo
WJMIRVSLPFY -> threetwoone
WJMIRABVLKF -> threeonesix
WJMIRABVKWO -> threeonetwo
WJMIRABVPFY -> threeoneone
WUPZNBKMVFY -> twoninenine
WUPZNBKUVXY -> twoninefive
WUPZNBKUPYL -> twoninefour
WUPZNBKAZBO -> twoninezero
WUPINIHGLKF -> twoeightsix
WUPINIHGKWO -> twoeighttwo
WUPINIHGPFY -> twoeightone
WUPURTKMLKF -> twosevensix
WUPURTKMKWO -> twoseventwo
WUPURTKMPFY -> twosevenone
WUPUNRKRXLJ -> twosixeight
WUPUNRWVIOP -> twosixseven
WUPUNRVSMOY -> twosixthree
WUPHNTKMVFY -> twofivenine
WUPHNTKUVXY -> twofivefive
WUPHNTKUPYL -> twofivefour
WUPHNTKAZBO -> twofivezero
WUPHHUXMVFY -> twofournine
WUPHHUXUVXY -> twofourfive
WUPHHUXUPYL -> twofourfour
WUPHHUXAZBO -> twofourzero
WUPTOXKVLKF -> twothreesix
WUPTOXKVKWO -> twothreetwo
WUPTOXKVPFY -> twothreeone
WUPTZAKRXLJ -> twotwoeight
WUPTZAWVIOP -> twotwoseven
WUPTZAVSMOY -> twotwothree
WUPYIKKRXLJ -> twooneeight
WUPYIKWVIOP -> twooneseven
WUPYIKVSMOY -> twoonethree
WUPNRXAMVFY -> twozeronine
WUPNRXAUVXY -> twozerofive
WUPNRXAUPYL -> twozerofour
WUPNRXAAZBO -> twozerozero
BDZZNBKMVFY -> oneninenine
BDZZNBKUVXY -> oneninefive
BDZZNBKUPYL -> oneninefour
BDZZNBKAZBO -> oneninezero
BDZINIHGLKF -> oneeightsix
BDZINIHGKWO -> oneeighttwo
BDZINIHGPFY -> oneeightone
BDZURTKMLKF -> onesevensix
BDZURTKMKWO -> oneseventwo
BDZURTKMPFY -> onesevenone
BDZUNRKRXLJ -> onesixeight
BDZUNRWVIOP -> onesixseven
BDZUNRVSMOY -> onesixthree
BDZHNTKMVFY -> onefivenine
BDZHNTKUVXY -> onefivefive
BDZHNTKUPYL -> onefivefour
BDZHNTKAZBO -> onefivezero
BDZHHUXMVFY -> onefournine
BDZHHUXUVXY -> onefourfive
BDZHHUXUPYL -> onefourfour
BDZHHUXAZBO -> onefourzero
BDZTOXKVLKF -> onethreesix
BDZTOXKVKWO -> onethreetwo
BDZTOXKVPFY -> onethreeone
BDZTZAKRXLJ -> onetwoeight
BDZTZAWVIOP -> onetwoseven
BDZTZAVSMOY -> onetwothree
BDZYIKKRXLJ -> oneoneeight
BDZYIKWVIOP -> oneoneseven
BDZYIKVSMOY -> oneonethree
BDZNRXAMVFY -> onezeronine
BDZNRXAUVXY -> onezerofive
BDZNRXAUPYL -> onezerofour
BDZNRXAAZBO -> onezerozero
QMMYIGBVLKF -> zeroninesix
QMMYIGBVKWO -> zeroninetwo
QMMYIGBVPFY -> zeronineone
QMMYDGRMVFY -> zerosixnine
QMMYDGRUVXY -> zerosixfive
QMMYDGRUPYL -> zerosixfour
QMMYDGRAZBO -> zerosixzero
QMMYQGTVLKF -> zerofivesix
QMMYQGTVKWO -> zerofivetwo
QMMYQGTVPFY -> zerofiveone
QMMYQAUILKF -> zerofoursix
QMMYQAUIKWO -> zerofourtwo
QMMYQAUIPFY -> zerofourone
QMMYCSAMVFY -> zerotwonine
QMMYCSAUVXY -> zerotwofive
QMMYCSAUPYL -> zerotwofour
QMMYCSAAZBO -> zerotwozero
QMMYHBKMVFY -> zeroonenine
QMMYHBKUVXY -> zeroonefive
QMMYHBKUPYL -> zeroonefour
QMMYHBKAZBO -> zeroonezero
QMMYWKXLLKF -> zerozerosix
QMMYWKXLKWO -> zerozerotwo
QMMYWKXLPFY -> zerozeroone

UXURTSUBYZBHJBM -> eighteighteight
UXURTSUBYZNLUES -> eighteightseven
UXURTSUBYZMIYEB -> eighteightthree
UXURTEYMBFBHJBM -> eightseveneight
UXURTEYMBFNLUES -> eightsevenseven
UXURTEYMBFMIYEB -> eightseventhree
UXURTDVQBOBHJBM -> eightthreeeight
UXURTDVQBONLUES -> eightthreeseven
UXURTDVQBOMIYEB -> eightthreethree
GBFUZSUBYZBHJBM -> seveneighteight
GBFUZSUBYZNLUES -> seveneightseven
GBFUZSUBYZMIYEB -> seveneightthree
GBFUZEYMBFBHJBM -> sevenseveneight
GBFUZEYMBFNLUES -> sevensevenseven
GBFUZEYMBFMIYEB -> sevenseventhree
GBFUZDVQBOBHJBM -> seventhreeeight
GBFUZDVQBONLUES -> seventhreeseven
GBFUZDVQBOMIYEB -> seventhreethree
FYJUISUBYZBHJBM -> threeeighteight
FYJUISUBYZNLUES -> threeeightseven
FYJUISUBYZMIYEB -> threeeightthree
FYJUIEYMBFBHJBM -> threeseveneight
FYJUIEYMBFNLUES -> threesevenseven
FYJUIEYMBFMIYEB -> threeseventhree
FYJUIDVQBOBHJBM -> threethreeeight
FYJUIDVQBONLUES -> threethreeseven
FYJUIDVQBOMIYEB -> threethreethree

VVQERDJEE -> sixsixsix
VVQERDIQN -> sixsixtwo
VVQERDNZX -> sixsixone
VVQDDMJEE -> sixtwosix
VVQDDMIQN -> sixtwotwo
VVQDDMNZX -> sixtwoone
VVQIMWJEE -> sixonesix
VVQIMWIQN -> sixonetwo
VVQIMWNZX -> sixoneone
UHZERDJEE -> twosixsix
UHZERDIQN -> twosixtwo
UHZERDNZX -> twosixone
UHZDDMJEE -> twotwosix
UHZDDMIQN -> twotwotwo
UHZDDMNZX -> twotwoone
UHZIMWJEE -> twoonesix
UHZIMWIQN -> twoonetwo
UHZIMWNZX -> twooneone
ZQJERDJEE -> onesixsix
ZQJERDIQN -> onesixtwo
ZQJERDNZX -> onesixone
ZQJDDMJEE -> onetwosix
ZQJDDMIQN -> onetwotwo
ZQJDDMNZX -> onetwoone
ZQJIMWJEE -> oneonesix
ZQJIMWIQN -> oneonetwo
ZQJIMWNZX -> oneoneone

VOYPKEKRIAZP -> nineninenine
VOYPKEKRQARP -> nineninefive
VOYPKEKRQUSC -> nineninefour
VOYPKEKRWEVF -> nineninezero
VOYPTEROCQEW -> nineeightsix
VOYPTEROCPQF -> nineeighttwo
VOYPTEROCUZP -> nineeightone
VOYPFICRIQEW -> ninesevensix
VOYPFICRIPQF -> nineseventwo
VOYPFICRIUZP -> ninesevenone
VOYPFEARNCFA -> ninesixeight
VOYPFEADRNIG -> ninesixseven
VOYPFEACORIP -> ninesixthree
VOYPSECRIAZP -> ninefivenine
VOYPSECRQARP -> ninefivefive
VOYPSECRQUSC -> ninefivefour
VOYPSECRWEVF -> ninefivezero
VOYPSYDEIAZP -> ninefournine
VOYPSYDEQARP -> ninefourfive
VOYPSYDEQUSC -> ninefourfour
VOYPSYDEWEVF -> ninefourzero
VOYPEFGRRQEW -> ninethreesix
VOYPEFGRRPQF -> ninethreetwo
VOYPEFGRRUZP -> ninethreeone
VOYPEQJRNCFA -> ninetwoeight
VOYPEQJDRNIG -> ninetwoseven
VOYPEQJCORIP -> ninetwothree
VOYPJZTRNCFA -> nineoneeight
VOYPJZTDRNIG -> nineoneseven
VOYPJZTCORIP -> nineonethree
VOYPYIGHIAZP -> ninezeronine
VOYPYIGHQARP -> ninezerofive
VOYPYIGHQUSC -> ninezerofour
VOYPYIGHWEVF -> ninezerozero
EOFMEZPIRQEW -> eightninesix
EOFMEZPIRPQF -> eightninetwo
EOFMEZPIRUZP -> eightnineone
EOFMEUPYIAZP -> eightsixnine
EOFMEUPYQARP -> eightsixfive
EOFMEUPYQUSC -> eightsixfour
EOFMEUPYWEVF -> eightsixzero
EOFMEHPARQEW -> eightfivesix
EOFMEHPARPQF -> eightfivetwo
EOFMEHPARUZP -> eightfiveone
EOFMEHJBEQEW -> eightfoursix
EOFMEHJBEPQF -> eightfourtwo
EOFMEHJBEUZP -> eightfourone
EOFMETBHIAZP -> eighttwonine
EOFMETBHQARP -> eighttwofive
EOFMETBHQUSC -> eighttwofour
EOFMETBHWEVF -> eighttwozero
EOFMEYKRIAZP -> eightonenine
EOFMEYKRQARP -> eightonefive
EOFMEYKRQUSC -> eightonefour
EOFMEYKRWEVF -> eightonezero
EOFMENTEHQEW -> eightzerosix
EOFMENTEHPQF -> eightzerotwo
EOFMENTEHUZP -> eightzeroone
QSQPKZPIRQEW -> sevenninesix
QSQPKZPIRPQF -> sevenninetwo
QSQPKZPIRUZP -> sevennineone
QSQPKUPYIAZP -> sevensixnine
QSQPKUPYQARP -> sevensixfive
QSQPKUPYQUSC -> sevensixfour
QSQPKUPYWEVF -> sevensixzero
QSQPKHPARQEW -> sevenfivesix
QSQPKHPARPQF -> sevenfivetwo
QSQPKHPARUZP -> sevenfiveone
QSQPKHJBEQEW -> sevenfoursix
QSQPKHJBEPQF -> sevenfourtwo
QSQPKHJBEUZP -> sevenfourone
QSQPKTBHIAZP -> seventwonine
QSQPKTBHQARP -> seventwofive
QSQPKTBHQUSC -> seventwofour
QSQPKTBHWEVF -> seventwozero
QSQPKYKRIAZP -> sevenonenine
QSQPKYKRQARP -> sevenonefive
QSQPKYKRQUSC -> sevenonefour
QSQPKYKRWEVF -> sevenonezero
QSQPKNTEHQEW -> sevenzerosix
QSQPKNTEHPQF -> sevenzerotwo
QSQPKNTEHUZP -> sevenzeroone
QOOGPZTRNCFA -> sixnineeight
QOOGPZTDRNIG -> sixnineseven
QOOGPZTCORIP -> sixninethree
QOOPPGQCIAZP -> sixeightnine
QOOPPGQCQARP -> sixeightfive
QOOPPGQCQUSC -> sixeightfour
QOOPPGQCWEVF -> sixeightzero
QOOBTRTIIAZP -> sixsevennine
QOOBTRTIQARP -> sixsevenfive
QOOBTRTIQUSC -> sixsevenfour
QOOBTRTIWEVF -> sixsevenzero
QOOOPRTRNCFA -> sixfiveeight
QOOOPRTDRNIG -> sixfiveseven
QOOOPRTCORIP -> sixfivethree
QOOOJSGRNCFA -> sixfoureight
QOOOJSGDRNIG -> sixfourseven
QOOOJSGCORIP -> sixfourthree
QOOAQVTRIAZP -> sixthreenine
QOOAQVTRQARP -> sixthreefive
QOOAQVTRQUSC -> sixthreefour
QOOAQVTRWEVF -> sixthreezero
QOOUTVJRNCFA -> sixzeroeight
QOOUTVJDRNIG -> sixzeroseven
QOOUTVJCORIP -> sixzerothree
DOQPKEKRIAZP -> fiveninenine
DOQPKEKRQARP -> fiveninefive
DOQPKEKRQUSC -> fiveninefour
DOQPKEKRWEVF -> fiveninezero
DOQPTEROCQEW -> fiveeightsix
DOQPTEROCPQF -> fiveeighttwo
DOQPTEROCUZP -> fiveeightone
DOQPFICRIQEW -> fivesevensix
DOQPFICRIPQF -> fiveseventwo
DOQPFICRIUZP -> fivesevenone
DOQPFEARNCFA -> fivesixeight
DOQPFEADRNIG -> fivesixseven
DOQPFEACORIP -> fivesixthree
DOQPSECRIAZP -> fivefivenine
DOQPSECRQARP -> fivefivefive
DOQPSECRQUSC -> fivefivefour
DOQPSECRWEVF -> fivefivezero
DOQPSYDEIAZP -> fivefournine
DOQPSYDEQARP -> fivefourfive
DOQPSYDEQUSC -> fivefourfour
DOQPSYDEWEVF -> fivefourzero
DOQPEFGRRQEW -> fivethreesix
DOQPEFGRRPQF -> fivethreetwo
DOQPEFGRRUZP -> fivethreeone
DOQPEQJRNCFA -> fivetwoeight
DOQPEQJDRNIG -> fivetwoseven
DOQPEQJCORIP -> fivetwothree
DOQPJZTRNCFA -> fiveoneeight
DOQPJZTDRNIG -> fiveoneseven
DOQPJZTCORIP -> fiveonethree
DOQPYIGHIAZP -> fivezeronine
DOQPYIGHQARP -> fivezerofive
DOQPYIGHQUSC -> fivezerofour
DOQPYIGHWEVF -> fivezerozero
DIRCKEKRIAZP -> fourninenine
DIRCKEKRQARP -> fourninefive
DIRCKEKRQUSC -> fourninefour
DIRCKEKRWEVF -> fourninezero
DIRCTEROCQEW -> foureightsix
DIRCTEROCPQF -> foureighttwo
DIRCTEROCUZP -> foureightone
DIRCFICRIQEW -> foursevensix
DIRCFICRIPQF -> fourseventwo
DIRCFICRIUZP -> foursevenone
DIRCFEARNCFA -> foursixeight
DIRCFEADRNIG -> foursixseven
DIRCFEACORIP -> foursixthree
DIRCSECRIAZP -> fourfivenine
DIRCSECRQARP -> fourfivefive
DIRCSECRQUSC -> fourfivefour
DIRCSECRWEVF -> fourfivezero
DIRCSYDEIAZP -> fourfournine
DIRCSYDEQARP -> fourfourfive
DIRCSYDEQUSC -> fourfourfour
DIRCSYDEWEVF -> fourfourzero
DIRCEFGRRQEW -> fourthreesix
DIRCEFGRRPQF -> fourthreetwo
DIRCEFGRRUZP -> fourthreeone
DIRCEQJRNCFA -> fourtwoeight
DIRCEQJDRNIG -> fourtwoseven
DIRCEQJCORIP -> fourtwothree
DIRCJZTRNCFA -> fouroneeight
DIRCJZTDRNIG -> fouroneseven
DIRCJZTCORIP -> fouronethree
DIRCYIGHIAZP -> fourzeronine
DIRCYIGHQARP -> fourzerofive
DIRCYIGHQUSC -> fourzerofour
DIRCYIGHWEVF -> fourzerozero
PPUPTZPIRQEW -> threeninesix
PPUPTZPIRPQF -> threeninetwo
PPUPTZPIRUZP -> threenineone
PPUPTUPYIAZP -> threesixnine
PPUPTUPYQARP -> threesixfive
PPUPTUPYQUSC -> threesixfour
PPUPTUPYWEVF -> threesixzero
PPUPTHPARQEW -> threefivesix
PPUPTHPARPQF -> threefivetwo
PPUPTHPARUZP -> threefiveone
PPUPTHJBEQEW -> threefoursix
PPUPTHJBEPQF -> threefourtwo
PPUPTHJBEUZP -> threefourone
PPUPTTBHIAZP -> threetwonine
PPUPTTBHQARP -> threetwofive
PPUPTTBHQUSC -> threetwofour
PPUPTTBHWEVF -> threetwozero
PPUPTYKRIAZP -> threeonenine
PPUPTYKRQARP -> threeonefive
PPUPTYKRQUSC -> threeonefour
PPUPTYKRWEVF -> threeonezero
PPUPTNTEHQEW -> threezerosix
PPUPTNTEHPQF -> threezerotwo
PPUPTNTEHUZP -> threezeroone
PAXGPZTRNCFA -> twonineeight
PAXGPZTDRNIG -> twonineseven
PAXGPZTCORIP -> twoninethree
PAXPPGQCIAZP -> twoeightnine
PAXPPGQCQARP -> twoeightfive
PAXPPGQCQUSC -> twoeightfour
PAXPPGQCWEVF -> twoeightzero
PAXBTRTIIAZP -> twosevennine
PAXBTRTIQARP -> twosevenfive
PAXBTRTIQUSC -> twosevenfour
PAXBTRTIWEVF -> twosevenzero
PAXOPRTRNCFA -> twofiveeight
PAXOPRTDRNIG -> twofiveseven
PAXOPRTCORIP -> twofivethree
PAXOJSGRNCFA -> twofoureight
PAXOJSGDRNIG -> twofourseven
PAXOJSGCORIP -> twofourthree
PAXAQVTRIAZP -> twothreenine
PAXAQVTRQARP -> twothreefive
PAXAQVTRQUSC -> twothreefour
PAXAQVTRWEVF -> twothreezero
PAXUTVJRNCFA -> twozeroeight
PAXUTVJDRNIG -> twozeroseven
PAXUTVJCORIP -> twozerothree
UJHGPZTRNCFA -> onenineeight
UJHGPZTDRNIG -> onenineseven
UJHGPZTCORIP -> oneninethree
UJHPPGQCIAZP -> oneeightnine
UJHPPGQCQARP -> oneeightfive
UJHPPGQCQUSC -> oneeightfour
UJHPPGQCWEVF -> oneeightzero
UJHBTRTIIAZP -> onesevennine
UJHBTRTIQARP -> onesevenfive
UJHBTRTIQUSC -> onesevenfour
UJHBTRTIWEVF -> onesevenzero
UJHOPRTRNCFA -> onefiveeight
UJHOPRTDRNIG -> onefiveseven
UJHOPRTCORIP -> onefivethree
UJHOJSGRNCFA -> onefoureight
UJHOJSGDRNIG -> onefourseven
UJHOJSGCORIP -> onefourthree
UJHAQVTRIAZP -> onethreenine
UJHAQVTRQARP -> onethreefive
UJHAQVTRQUSC -> onethreefour
UJHAQVTRWEVF -> onethreezero
UJHUTVJRNCFA -> onezeroeight
UJHUTVJDRNIG -> onezeroseven
UJHUTVJCORIP -> onezerothree
JSUFKEKRIAZP -> zeroninenine
JSUFKEKRQARP -> zeroninefive
JSUFKEKRQUSC -> zeroninefour
JSUFKEKRWEVF -> zeroninezero
JSUFTEROCQEW -> zeroeightsix
JSUFTEROCPQF -> zeroeighttwo
JSUFTEROCUZP -> zeroeightone
JSUFFICRIQEW -> zerosevensix
JSUFFICRIPQF -> zeroseventwo
JSUFFICRIUZP -> zerosevenone
JSUFFEARNCFA -> zerosixeight
JSUFFEADRNIG -> zerosixseven
JSUFFEACORIP -> zerosixthree
JSUFSECRIAZP -> zerofivenine
JSUFSECRQARP -> zerofivefive
JSUFSECRQUSC -> zerofivefour
JSUFSECRWEVF -> zerofivezero
JSUFSYDEIAZP -> zerofournine
JSUFSYDEQARP -> zerofourfive
JSUFSYDEQUSC -> zerofourfour
JSUFSYDEWEVF -> zerofourzero
JSUFEFGRRQEW -> zerothreesix
JSUFEFGRRPQF -> zerothreetwo
JSUFEFGRRUZP -> zerothreeone
JSUFEQJRNCFA -> zerotwoeight
JSUFEQJDRNIG -> zerotwoseven
JSUFEQJCORIP -> zerotwothree
JSUFJZTRNCFA -> zerooneeight
JSUFJZTDRNIG -> zerooneseven
JSUFJZTCORIP -> zeroonethree
JSUFYIGHIAZP -> zerozeronine
JSUFYIGHQARP -> zerozerofive
JSUFYIGHQUSC -> zerozerofour
JSUFYIGHWEVF -> zerozerozero

GAPFBCXSYX -> ninesixsix
GAPFBCXRKG -> ninesixtwo
GAPFBCXWTQ -> ninesixone
GAPFAOGSYX -> ninetwosix
GAPFAOGRKG -> ninetwotwo
GAPFAOGWTQ -> ninetwoone
GAPFFXQSYX -> nineonesix
GAPFFXQRKG -> nineonetwo
GAPFFXQWTQ -> nineoneone
BAFWLXQSYX -> sixninesix
BAFWLXQRKG -> sixninetwo
BAFWLXQWTQ -> sixnineone
BAFRLNHCTQ -> sixsixnine
BAFRLNPCLQ -> sixsixfive
BAFRLNPWMD -> sixsixfour
BAFRLNVGPG -> sixsixzero
BAFELPQSYX -> sixfivesix
BAFELPQRKG -> sixfivetwo
BAFELPQWTQ -> sixfiveone
BAFEFQDSYX -> sixfoursix
BAFEFQDRKG -> sixfourtwo
BAFEFQDWTQ -> sixfourone
BAFQXWHCTQ -> sixtwonine
BAFQXWPCLQ -> sixtwofive
BAFQXWPWMD -> sixtwofour
BAFQXWVGPG -> sixtwozero
BAFVGGHCTQ -> sixonenine
BAFVGGPCLQ -> sixonefive
BAFVGGPWMD -> sixonefour
BAFVGGVGPG -> sixonezero
BAFKPTGSYX -> sixzerosix
BAFKPTGRKG -> sixzerotwo
BAFKPTGWTQ -> sixzeroone
OAHFBCXSYX -> fivesixsix
OAHFBCXRKG -> fivesixtwo
OAHFBCXWTQ -> fivesixone
OAHFAOGSYX -> fivetwosix
OAHFAOGRKG -> fivetwotwo
OAHFAOGWTQ -> fivetwoone
OAHFFXQSYX -> fiveonesix
OAHFFXQRKG -> fiveonetwo
OAHFFXQWTQ -> fiveoneone
OUISBCXSYX -> foursixsix
OUISBCXRKG -> foursixtwo
OUISBCXWTQ -> foursixone
OUISAOGSYX -> fourtwosix
OUISAOGRKG -> fourtwotwo
OUISAOGWTQ -> fourtwoone
OUISFXQSYX -> fouronesix
OUISFXQRKG -> fouronetwo
OUISFXQWTQ -> fouroneone
AMOWLXQSYX -> twoninesix
AMOWLXQRKG -> twoninetwo
AMOWLXQWTQ -> twonineone
AMORLNHCTQ -> twosixnine
AMORLNPCLQ -> twosixfive
AMORLNPWMD -> twosixfour
AMORLNVGPG -> twosixzero
AMOELPQSYX -> twofivesix
AMOELPQRKG -> twofivetwo
AMOELPQWTQ -> twofiveone
AMOEFQDSYX -> twofoursix
AMOEFQDRKG -> twofourtwo
AMOEFQDWTQ -> twofourone
AMOQXWHCTQ -> twotwonine
AMOQXWPCLQ -> twotwofive
AMOQXWPWMD -> twotwofour
AMOQXWVGPG -> twotwozero
AMOVGGHCTQ -> twoonenine
AMOVGGPCLQ -> twoonefive
AMOVGGPWMD -> twoonefour
AMOVGGVGPG -> twoonezero
AMOKPTGSYX -> twozerosix
AMOKPTGRKG -> twozerotwo
AMOKPTGWTQ -> twozeroone
FVYWLXQSYX -> oneninesix
FVYWLXQRKG -> oneninetwo
FVYWLXQWTQ -> onenineone
FVYRLNHCTQ -> onesixnine
FVYRLNPCLQ -> onesixfive
FVYRLNPWMD -> onesixfour
FVYRLNVGPG -> onesixzero
FVYELPQSYX -> onefivesix
FVYELPQRKG -> onefivetwo
FVYELPQWTQ -> onefiveone
FVYEFQDSYX -> onefoursix
FVYEFQDRKG -> onefourtwo
FVYEFQDWTQ -> onefourone
FVYQXWHCTQ -> onetwonine
FVYQXWPCLQ -> onetwofive
FVYQXWPWMD -> onetwofour
FVYQXWVGPG -> onetwozero
FVYVGGHCTQ -> oneonenine
FVYVGGPCLQ -> oneonefive
FVYVGGPWMD -> oneonefour
FVYVGGVGPG -> oneonezero
FVYKPTGSYX -> onezerosix
FVYKPTGRKG -> onezerotwo
FVYKPTGWTQ -> onezeroone
UELVBCXSYX -> zerosixsix
UELVBCXRKG -> zerosixtwo
UELVBCXWTQ -> zerosixone
UELVAOGSYX -> zerotwosix
UELVAOGRKG -> zerotwotwo
UELVAOGWTQ -> zerotwoone
UELVFXQSYX -> zeroonesix
UELVFXQRKG -> zeroonetwo
UELVFXQWTQ -> zerooneone
